full_name,age,league,position,Current Club,minutes_played_overall,minutes_played_home,minutes_played_away,appearances_overall,appearances_home,appearances_away,goals_overall,goals_home,goals_away,assists_overall,penalty_goals,conceded_overall,conceded_home,conceded_away,yellow_cards_overall,goals_involved_per_90_overall,assists_per_90_overall,goals_per_90_overall,goals_per_90_home,goals_per_90_away,min_per_goal_overall,min_per_match,min_per_assist_overall
Aaron Anthony Connolly,20,Premier League,Forward,Brighton & Hove Albion,1262,592,670,24,11,13,3,2,1,1,0,21,10,11,0,0.29,0.07,0.21,0.3,0.13,421,53,1262
Aaron Cresswell,30,Premier League,Defender,West Ham United,2730,1395,1335,31,16,15,3,1,2,0,0,49,25,24,7,0.1,0,0.1,0.06,0.13,910,88,0
Aaron Lennon,33,Premier League,Midfielder,Burnley,485,225,260,16,9,7,0,0,0,0,0,14,8,6,4,0,0,0,0,0,0,30,0
Aaron Mooy,30,Premier League,Midfielder,Brighton & Hove Albion,2090,1010,1080,31,16,15,2,1,1,2,0,30,15,15,3,0.17,0.09,0.09,0.09,0.08,1045,67,1045
Aaron Ramsdale,22,Premier League,Goalkeeper,AFC Bournemouth,3330,1620,1710,37,18,19,0,0,0,1,0,61,26,35,0,0.03,0.03,0,0,0,0,90,3330
Aaron Wan-Bissaka,22,Premier League,Midfielder,Manchester United,3071,1574,1497,35,18,17,0,0,0,4,0,29,13,16,8,0.12,0.12,0,0,0,0,88,768
Abdoulaye Doucouré,27,Premier League,Midfielder,Watford,3166,1655,1511,37,19,18,4,1,3,2,0,57,25,32,9,0.17,0.06,0.11,0.05,0.18,792,86,1583
Adalberto Peñaranda Maestre,23,Premier League,Forward,Watford,0,0,0,0,0,0,0,0,0,0,0,0,0,0,0,0,0,0,0,0,0,0,0
Adam David Lallana,32,Premier League,Midfielder,Liverpool,373,198,175,15,9,6,1,0,1,1,0,5,3,2,1,0.48,0.24,0.24,0,0.51,373,25,373
Adam Masina,26,Premier League,Defender,Watford,1819,935,884,26,14,12,1,1,0,0,0,27,11,16,3,0.05,0,0.05,0.1,0,1819,70,0
Adam Smith,29,Premier League,Defender,AFC Bournemouth,2060,1031,1029,24,12,12,0,0,0,1,0,39,18,21,7,0.04,0.04,0,0,0,0,86,2060
Adam Uche Idah,19,Premier League,Forward,Norwich City,219,69,150,12,6,6,0,0,0,0,0,8,1,7,0,0,0,0,0,0,0,18,0
Adam Webster,25,Premier League,Defender,Brighton & Hove Albion,2670,1206,1464,31,14,17,3,0,3,1,0,42,19,23,4,0.13,0.03,0.1,0,0.18,890,86,2670
Adama Traoré Diarra,24,Premier League,Midfielder,Wolverhampton Wanderers,2605,1254,1351,37,19,18,4,2,2,9,0,30,14,16,1,0.45,0.31,0.14,0.14,0.13,651,70,289
Adrian Mariappa,34,Premier League,Defender,Watford,1509,590,919,20,8,12,0,0,0,0,0,27,10,17,6,0,0,0,0,0,0,75,0
Adrián San Miguel del Castillo,33,Premier League,Goalkeeper,Liverpool,873,513,360,11,7,4,0,0,0,0,0,10,8,2,1,0,0,0,0,0,0,79,0
Ahmed Eissa El Mohamady Abdel Fattah,33,Premier League,Midfielder,Aston Villa,1026,568,458,18,11,7,1,0,1,1,0,25,14,11,1,0.18,0.09,0.09,0,0.2,1026,57,1026
Ainsley Maitland-Niles,23,Premier League,Midfielder,Arsenal,1382,685,697,20,10,10,0,0,0,2,0,20,12,8,6,0.13,0.13,0,0,0,0,69,691
Akin Famewo,22,Premier League,Defender,Norwich City,0,0,0,1,0,1,0,0,0,0,0,0,0,0,0,0,0,0,0,0,0,0,0
Albian Ajeti,23,Premier League,Forward,West Ham United,130,78,52,9,5,4,0,0,0,0,0,2,1,1,0,0,0,0,0,0,0,14,0
Alex Iwobi,24,Premier League,Forward,Everton,1604,754,850,25,12,13,1,1,0,0,0,27,9,18,0,0.06,0,0.06,0.12,0,1604,64,0
Alex McCarthy,30,Premier League,Goalkeeper,Southampton,2520,1260,1260,28,14,14,0,0,0,0,0,33,16,17,0,0,0,0,0,0,0,90,0
Alex Oxlade-Chamberlain,27,Premier League,Midfielder,Liverpool,1489,560,929,30,13,17,4,2,2,1,0,12,3,9,1,0.3,0.06,0.24,0.32,0.19,372,50,1489
Alexander Banor Tettey,34,Premier League,Midfielder,Norwich City,2351,1227,1124,30,15,15,1,1,0,1,0,43,23,20,5,0.08,0.04,0.04,0.07,0,2351,78,2351
Alexander Cochrane,0,Premier League,Midfielder,Brighton & Hove Albion,0,0,0,0,0,0,0,0,0,0,0,0,0,0,0,0,0,0,0,0,0,0,0
Alexandre Jankewitz,18,Premier League,Midfielder,Southampton,0,0,0,0,0,0,0,0,0,0,0,0,0,0,0,0,0,0,0,0,0,0,0
Alexandre Lacazette,29,Premier League,Forward,Arsenal,1878,998,880,30,15,15,10,8,2,4,0,24,12,12,8,0.67,0.19,0.48,0.72,0.2,188,63,470
Alexandre Nascimento Costa Silva,23,Premier League,Forward,West Ham United,0,0,0,0,0,0,0,0,0,0,0,0,0,0,0,0,0,0,0,0,0,0,0
Alexis Mac Allister,21,Premier League,Midfielder,Brighton & Hove Albion,351,184,167,9,4,5,0,0,0,0,0,6,5,1,0,0,0,0,0,0,0,39,0
Alfie Lewis,21,Premier League,Midfielder,West Ham United,0,0,0,0,0,0,0,0,0,0,0,0,0,0,0,0,0,0,0,0,0,0,0
Alfie Whiteman,22,Premier League,Goalkeeper,Tottenham Hotspur,0,0,0,0,0,0,0,0,0,0,0,0,0,0,0,0,0,0,0,0,0,0,0
Ali Koiki,20,Premier League,Defender,Burnley,0,0,0,0,0,0,0,0,0,0,0,0,0,0,0,0,0,0,0,0,0,0,0
Alireza Jahanbakhsh,27,Premier League,Forward,Brighton & Hove Albion,307,177,130,10,6,4,2,2,0,0,0,4,1,3,0,0.59,0,0.59,1.02,0,154,31,0
Alisson Becker,28,Premier League,Goalkeeper,Liverpool,2545,1195,1350,29,14,15,0,0,0,1,0,23,8,15,1,0.04,0.04,0,0,0,0,88,2545
Allan Saint-Maximin,23,Premier League,Midfielder,Newcastle United,1874,1028,846,26,15,11,3,1,2,4,0,19,10,9,0,0.34,0.19,0.14,0.09,0.21,625,72,469
André Filipe Tavares Gomes,27,Premier League,Midfielder,Everton,1460,838,622,19,10,9,0,0,0,1,0,18,10,8,6,0.06,0.06,0,0,0,0,77,1460
Andre Gray,29,Premier League,Forward,Watford,744,470,274,23,9,14,2,1,1,0,0,14,10,4,1,0.24,0,0.24,0.19,0.33,372,32,0
Andreas Christensen,24,Premier League,Defender,Chelsea,1754,808,946,21,10,11,0,0,0,0,0,32,9,23,5,0,0,0,0,0,0,84,0
Andreas Pereira,24,Premier League,Midfielder,Manchester United,1490,787,703,25,12,13,1,1,0,3,0,16,7,9,3,0.24,0.18,0.06,0.11,0,1490,60,497
Andrew Lonergan,37,Premier League,Goalkeeper,Liverpool,0,0,0,0,0,0,0,0,0,0,0,0,0,0,0,0,0,0,0,0,0,0,0
Andrew Robertson,26,Premier League,Defender,Liverpool,3113,1553,1560,36,18,18,2,1,1,12,0,31,15,16,2,0.4,0.35,0.06,0.06,0.06,1557,86,259
Andrew Surman,34,Premier League,Midfielder,AFC Bournemouth,233,0,233,5,0,5,0,0,0,0,0,6,0,6,1,0,0,0,0,0,0,47,0
Andriy Yarmolenko,31,Premier League,Forward,West Ham United,986,566,420,23,11,12,5,4,1,1,0,16,10,6,2,0.55,0.09,0.46,0.64,0.21,197,43,986
Andros Townsend,29,Premier League,Midfielder,Crystal Palace,1290,567,723,24,11,13,1,1,0,1,0,22,6,16,0,0.14,0.07,0.07,0.16,0,1290,54,1290
Andy Carroll,31,Premier League,Forward,Newcastle United,618,326,292,19,10,9,0,0,0,4,0,7,4,3,1,0.58,0.58,0,0,0,0,33,155
Angel Gomes,20,Premier League,Midfielder,Manchester United,19,10,9,2,1,1,0,0,0,0,0,1,0,1,0,0,0,0,0,0,0,10,0
Angelo Ogbonna,32,Premier League,Defender,West Ham United,2787,1260,1527,31,14,17,2,2,0,0,0,42,20,22,4,0.06,0,0.06,0.14,0,1394,90,0
Angus Gunn,24,Premier League,Goalkeeper,Southampton,900,450,450,10,5,5,0,0,0,0,0,23,17,6,0,0,0,0,0,0,0,90,0
Anthony Driscoll-Glennon,20,Premier League,Defender,Burnley,0,0,0,0,0,0,0,0,0,0,0,0,0,0,0,0,0,0,0,0,0,0,0
Anthony Gordon,19,Premier League,Midfielder,Everton,437,273,164,11,5,6,0,0,0,1,0,6,4,2,0,0.21,0.21,0,0,0,0,40,437
Anthony Martial,24,Premier League,Forward,Manchester United,2640,1273,1367,32,16,16,17,11,6,6,0,24,13,11,1,0.78,0.2,0.58,0.78,0.4,155,83,440
Antonio Rüdiger,27,Premier League,Defender,Chelsea,1710,900,810,20,10,10,2,0,2,0,0,23,9,14,3,0.11,0,0.11,0,0.22,855,86,0
Anwar El Ghazi,25,Premier League,Forward,Aston Villa,2060,1209,851,34,18,16,4,4,0,4,1,45,25,20,3,0.35,0.17,0.17,0.3,0,515,61,515
Archie Mair,19,Premier League,Goalkeeper,Norwich City,0,0,0,0,0,0,0,0,0,0,0,0,0,0,0,0,0,0,0,0,0,0,0
Armando Broja,19,Premier League,Forward,Chelsea,4,4,0,1,1,0,0,0,0,0,0,0,0,0,0,0,0,0,0,0,0,4,0
Arnaut Groeneveld,23,Premier League,Forward,AFC Bournemouth,626,320,306,14,7,7,0,0,0,0,0,12,7,5,0,0,0,0,0,0,0,45,0
Arthur Masuaku,27,Premier League,Defender,West Ham United,933,362,571,17,7,10,0,0,0,1,0,17,9,8,6,0.1,0.1,0,0,0,0,55,933
Artur Boruc,40,Premier League,Goalkeeper,AFC Bournemouth,0,0,0,0,0,0,0,0,0,0,0,0,0,0,0,0,0,0,0,0,0,0,0
Ashley Barnes,31,Premier League,Forward,Burnley,1362,750,612,19,11,8,6,3,3,0,1,21,12,9,4,0.4,0,0.4,0.36,0.44,227,72,0
Ashley Westwood,30,Premier League,Midfielder,Burnley,3150,1530,1620,35,17,18,2,1,1,6,0,37,16,21,9,0.23,0.17,0.06,0.06,0.06,1575,90,525
Ashley Young,35,Premier League,Midfielder,Manchester United,954,416,538,12,5,7,0,0,0,0,0,9,3,6,5,0,0,0,0,0,0,80,0
Axel Tuanzebe,23,Premier League,Defender,Manchester United,186,90,96,5,2,3,0,0,0,0,0,2,1,1,0,0,0,0,0,0,0,37,0
Aymeric Laporte,26,Premier League,Defender,Manchester City,1104,460,644,15,7,8,1,0,1,0,0,5,2,3,1,0.08,0,0.08,0,0.14,1104,74,0
Ayotomiwa Dele-Bashiru,21,Premier League,Midfielder,Watford,0,0,0,0,0,0,0,0,0,0,0,0,0,0,0,0,0,0,0,0,0,0,0
Ayoze Perez,27,Premier League,Forward,Leicester City,2019,922,1097,33,16,17,8,3,5,4,1,23,10,13,0,0.53,0.18,0.36,0.29,0.41,252,61,505
Bailey Peacock-Farrell,24,Premier League,Goalkeeper,Burnley,0,0,0,0,0,0,0,0,0,0,0,0,0,0,0,0,0,0,0,0,0,0,0
Bakayo Sako,0,Premier League,Midfielder,Arsenal,1755,834,921,26,13,13,1,0,1,5,0,17,7,10,6,0.31,0.26,0.05,0,0.1,1755,68,351
Ben Chilwell,23,Premier League,Defender,Leicester City,2376,1306,1070,27,15,12,3,1,2,3,0,24,15,9,3,0.23,0.11,0.11,0.07,0.17,792,88,792
Ben Davies,27,Premier League,Defender,Tottenham Hotspur,1432,646,786,18,9,9,0,0,0,0,0,18,6,12,6,0,0,0,0,0,0,80,0
Ben Foster,37,Premier League,Goalkeeper,Watford,3420,1710,1710,38,19,19,0,0,0,0,0,58,25,33,1,0,0,0,0,0,0,90,0
Ben Gibson,27,Premier League,Defender,Burnley,0,0,0,0,0,0,0,0,0,0,0,0,0,0,0,0,0,0,0,0,0,0,0
Ben Godfrey,22,Premier League,Midfielder,Norwich City,2646,1336,1310,30,15,15,0,0,0,0,0,59,30,29,4,0,0,0,0,0,0,88,0
Ben Mee,31,Premier League,Defender,Burnley,2880,1440,1440,32,16,16,1,0,1,1,0,43,18,25,7,0.06,0.03,0.03,0,0.06,2880,90,2880
Ben Osborn,26,Premier League,Midfielder,Sheffield United,589,403,186,13,7,6,0,0,0,0,0,3,1,2,0,0,0,0,0,0,0,45,0
Beni Baningime,32,Premier League,Midfielder,Everton,0,0,0,0,0,0,0,0,0,0,0,0,0,0,0,0,0,0,0,0,0,0,0
Benjamin Johnson,20,Premier League,Forward,West Ham United,270,180,90,3,2,1,0,0,0,0,0,3,2,1,0,0,0,0,0,0,0,90,0
Benjamin Mendy,26,Premier League,Defender,Manchester City,1497,826,671,19,10,9,0,0,0,2,0,10,4,6,3,0.12,0.12,0,0,0,0,79,749
Bernard Anício Caldeira Duarte,28,Premier League,Midfielder,Everton,1280,688,592,27,15,12,3,3,0,2,0,11,3,8,2,0.35,0.14,0.21,0.39,0,427,47,640
Bernard Patrick Ashley-Seal,21,Premier League,Forward,Wolverhampton Wanderers,0,0,0,0,0,0,0,0,0,0,0,0,0,0,0,0,0,0,0,0,0,0,0
Bernardo,25,Premier League,Defender,Brighton & Hove Albion,675,257,418,14,4,10,0,0,0,0,0,17,6,11,1,0,0,0,0,0,0,48,0
Bernardo Rusa,20,Premier League,Midfielder,West Ham United,0,0,0,0,0,0,0,0,0,0,0,0,0,0,0,0,0,0,0,0,0,0,0
Bernardo Silva,26,Premier League,Midfielder,Manchester City,2029,972,1057,34,17,17,6,4,2,7,0,23,8,15,5,0.58,0.31,0.27,0.37,0.17,338,60,290
Bernd Leno,28,Premier League,Goalkeeper,Arsenal,2650,1350,1300,30,15,15,0,0,0,0,0,38,20,18,2,0,0,0,0,0,0,88,0
Billy Gilmour,19,Premier League,Midfielder,Chelsea,191,111,80,6,5,1,0,0,0,0,0,3,1,2,0,0,0,0,0,0,0,32,0
Billy Sharp,34,Premier League,Forward,Sheffield United,1052,580,472,25,13,12,3,2,1,2,0,10,6,4,2,0.43,0.17,0.26,0.31,0.19,351,42,526
Bjorn Engels,26,Premier League,Defender,Aston Villa,1446,787,659,17,9,8,1,1,0,0,0,29,14,15,1,0.06,0,0.06,0.11,0,1446,85,0
Bobby Thomas,0,Premier League,Defender,Burnley,0,0,0,0,0,0,0,0,0,0,0,0,0,0,0,0,0,0,0,0,0,0,0
Borja Bastón,28,Premier League,Forward,Aston Villa,16,7,9,2,1,1,0,0,0,0,0,0,0,0,0,0,0,0,0,0,0,8,0
Brandon Austin,21,Premier League,Goalkeeper,Tottenham Hotspur,0,0,0,0,0,0,0,0,0,0,0,0,0,0,0,0,0,0,0,0,0,0,0
Brandon Leroy Pierrick Keutcha,18,Premier League,Midfielder,Crystal Palace,6,0,6,1,0,1,0,0,0,0,0,0,0,0,0,0,0,0,0,0,0,6,0
Brandon Pierrick,18,Premier League,Midfielder,Crystal Palace,7,0,7,1,0,1,0,0,0,0,0,0,0,0,0,0,0,0,0,0,0,7,0
Brandon Williams,20,Premier League,Defender,Manchester United,1005,511,494,17,8,9,1,0,1,0,0,9,6,3,6,0.09,0,0.09,0,0.18,1005,59,0
Bruno André Cavaco Jordão,22,Premier League,Midfielder,Wolverhampton Wanderers,6,0,6,1,0,1,0,0,0,0,0,0,0,0,0,0,0,0,0,0,0,6,0
Bruno Miguel Borges Fernandes,26,Premier League,Midfielder,Manchester United,1193,612,581,14,7,7,8,2,6,7,4,6,4,2,2,1.13,0.53,0.6,0.29,0.93,149,85,170
Caglar Söyüncü,24,Premier League,Defender,Leicester City,3037,1530,1507,34,17,17,1,0,1,1,0,30,15,15,5,0.06,0.03,0.03,0,0.06,3037,89,3037
Callum Hudson-Odoi,20,Premier League,Midfielder,Chelsea,851,457,394,22,12,10,1,1,0,5,0,13,4,9,1,0.63,0.53,0.11,0.2,0,851,39,170
Callum Robinson,25,Premier League,Forward,Sheffield United,676,195,481,16,6,10,1,0,1,1,0,6,1,5,1,0.27,0.13,0.13,0,0.19,676,42,676
Callum Wilson,28,Premier League,Forward,AFC Bournemouth,2910,1527,1383,35,18,17,8,4,4,1,0,51,24,27,10,0.28,0.03,0.25,0.24,0.26,364,83,2910
Calum Chambers,25,Premier League,Defender,Arsenal,1103,473,630,14,7,7,1,1,0,1,0,15,8,7,5,0.16,0.08,0.08,0.19,0,1103,79,1103
Caoimhin Kelleher,21,Premier League,Goalkeeper,Liverpool,0,0,0,0,0,0,0,0,0,0,0,0,0,0,0,0,0,0,0,0,0,0,0
Carlos Sánchez,34,Premier League,Midfielder,West Ham United,113,93,20,6,3,3,0,0,0,0,0,2,2,0,0,0,0,0,0,0,0,19,0
Cedric Soares,29,Premier League,Defender,Arsenal,1560,838,722,21,11,10,1,1,0,1,0,18,12,6,1,0.12,0.06,0.06,0.11,0,1560,74,1560
Cenk Tosun,29,Premier League,Forward,Crystal Palace,466,308,158,10,7,3,2,1,1,0,0,5,4,1,0,0.39,0,0.39,0.29,0.57,233,47,0
Cesar Azpilicueta,31,Premier League,Defender,Chelsea,3230,1530,1700,36,17,19,2,1,1,6,0,52,15,37,1,0.22,0.17,0.06,0.06,0.05,1615,90,538
Charlie Daniels,34,Premier League,Defender,AFC Bournemouth,127,37,90,2,1,1,0,0,0,0,0,2,1,1,0,0,0,0,0,0,0,64,0
Charlie Taylor,27,Premier League,Defender,Burnley,1945,911,1034,24,12,12,0,0,0,1,0,17,6,11,3,0.05,0.05,0,0,0,0,81,1945
Che Adams,24,Premier League,Midfielder,Southampton,1105,556,549,30,15,15,4,3,1,2,0,16,9,7,0,0.49,0.16,0.33,0.49,0.16,276,37,553
Cheikhou Kouyaté,30,Premier League,Midfielder,Crystal Palace,2536,1293,1243,35,17,18,1,1,0,1,0,34,13,21,4,0.07,0.04,0.04,0.07,0,2536,72,2536
Chris Basham,32,Premier League,Defender,Sheffield United,3255,1629,1626,38,19,19,0,0,0,1,0,36,14,22,4,0.03,0.03,0,0,0,0,86,3255
Chris Mepham,23,Premier League,Defender,AFC Bournemouth,910,460,450,12,7,5,1,1,0,0,0,19,9,10,1,0.1,0,0.1,0.2,0,910,76,0
Chris Wood,28,Premier League,Forward,Burnley,2446,1335,1111,32,16,16,14,9,5,1,1,31,16,15,1,0.55,0.04,0.52,0.61,0.41,175,76,2446
Christain Saydee,18,Premier League,Forward,AFC Bournemouth,0,0,0,0,0,0,0,0,0,0,0,0,0,0,0,0,0,0,0,0,0,0,0
Christian Atsu Twasam,28,Premier League,Midfielder,Newcastle United,739,205,534,19,7,12,0,0,0,3,0,12,2,10,2,0.37,0.37,0,0,0,0,39,246
Christian Benteke,29,Premier League,Forward,Crystal Palace,1257,584,673,24,11,13,2,1,1,1,0,17,7,10,5,0.21,0.07,0.14,0.15,0.13,629,52,1257
Christian Eriksen,28,Premier League,Midfielder,Tottenham Hotspur,1091,397,694,20,8,12,2,0,2,2,0,16,3,13,5,0.33,0.16,0.16,0,0.26,546,55,546
Christian Fuchs,34,Premier League,Defender,Leicester City,770,199,571,11,4,7,0,0,0,0,0,10,1,9,0,0,0,0,0,0,0,70,0
Christian Kabasele,29,Premier League,Defender,Watford,2252,1241,1011,27,14,13,0,0,0,2,0,30,13,17,4,0.08,0.08,0,0,0,0,83,1126
Christian Pulisic,22,Premier League,Midfielder,Chelsea,1727,870,857,25,12,13,9,2,7,4,0,28,7,21,0,0.68,0.21,0.47,0.21,0.74,192,69,432
Christoph Zimmermann,27,Premier League,Defender,Norwich City,1430,674,756,17,8,9,0,0,0,1,0,26,11,15,3,0.06,0.06,0,0,0,0,84,1430
Ciaran Clark,31,Premier League,Defender,Newcastle United,1189,586,603,14,7,7,2,1,1,0,0,13,4,9,3,0.15,0,0.15,0.15,0.15,595,85,0
Claudio Andrés Bravo Muñoz,37,Premier League,Goalkeeper,Manchester City,346,180,166,4,2,2,0,0,0,0,0,7,1,6,0,0,0,0,0,0,0,87,0
Cole Palmer,18,Premier League,Defender,Manchester City,0,0,0,0,0,0,0,0,0,0,0,0,0,0,0,0,0,0,0,0,0,0,0
Connor Wickham,27,Premier League,Forward,Crystal Palace,90,43,47,6,3,3,1,0,1,1,0,2,0,2,0,2,1,1,0,1.91,90,15,90
Conor Coady,27,Premier League,Midfielder,Wolverhampton Wanderers,3420,1710,1710,38,19,19,0,0,0,0,0,35,16,19,5,0,0,0,0,0,0,90,0
Conor Coventry,20,Premier League,Midfielder,West Ham United,0,0,0,0,0,0,0,0,0,0,0,0,0,0,0,0,0,0,0,0,0,0,0
Conor Hourihane,29,Premier League,Midfielder,Aston Villa,1539,826,713,27,13,14,3,2,1,5,0,27,14,13,4,0.47,0.29,0.18,0.22,0.13,513,57,308
Craig Cathcart,31,Premier League,Defender,Watford,2489,1185,1304,29,14,15,0,0,0,0,0,33,16,17,7,0,0,0,0,0,0,86,0
Craig Dawson,30,Premier League,Defender,Watford,2359,1188,1171,29,15,14,2,2,0,0,0,46,20,26,6,0.08,0,0.08,0.15,0,1180,81,0
Curtis Jones,19,Premier League,Midfielder,Liverpool,122,98,24,6,3,3,1,1,0,0,0,1,1,0,0,0.74,0,0.74,0.92,0,122,20,0
Dale Stephens,31,Premier League,Midfielder,Brighton & Hove Albion,2529,1185,1344,33,16,17,0,0,0,1,0,40,16,24,8,0.04,0.04,0,0,0,0,77,2529
Damián Emiliano Martínez,28,Premier League,Goalkeeper,Arsenal,770,360,410,9,4,5,0,0,0,0,0,8,4,4,2,0,0,0,0,0,0,86,0
Dan Burn,28,Premier League,Defender,Brighton & Hove Albion,2881,1441,1440,34,18,16,0,0,0,0,0,39,20,19,5,0,0,0,0,0,0,85,0
Dan Gosling,30,Premier League,Midfielder,AFC Bournemouth,1261,517,744,24,12,12,3,2,1,1,0,22,7,15,3,0.29,0.07,0.21,0.35,0.12,420,53,1261
Dan Nlundulu,21,Premier League,Forward,Southampton,0,0,0,0,0,0,0,0,0,0,0,0,0,0,0,0,0,0,0,0,0,0,0
Dani Ceballos,24,Premier League,Midfielder,Arsenal,1698,960,738,24,13,11,0,0,0,2,0,20,10,10,1,0.11,0.11,0,0,0,0,71,849
Daniel Adshead,19,Premier League,Midfielder,Norwich City,0,0,0,0,0,0,0,0,0,0,0,0,0,0,0,0,0,0,0,0,0,0,0
Daniel Castelo Podence,25,Premier League,Forward,Wolverhampton Wanderers,285,170,115,9,5,4,1,1,0,0,0,0,0,0,0,0.32,0,0.32,0.53,0,285,32,0
Daniel James,23,Premier League,Midfielder,Manchester United,2291,1131,1160,33,17,16,3,2,1,6,0,25,10,15,4,0.35,0.24,0.12,0.16,0.08,764,69,382
Daniel William John Ings,28,Premier League,Forward,Southampton,2815,1459,1356,38,19,19,22,10,12,2,1,42,26,16,3,0.77,0.06,0.7,0.62,0.8,128,74,1408
Danny Drinkwater,30,Premier League,Midfielder,Aston Villa,322,254,68,5,4,1,0,0,0,0,0,11,10,1,1,0,0,0,0,0,0,64,0
Danny Rose,30,Premier League,Defender,Newcastle United,1759,874,885,23,12,11,0,0,0,0,0,24,8,16,7,0,0,0,0,0,0,76,0
Danny Ward,27,Premier League,Goalkeeper,Leicester City,0,0,0,0,0,0,0,0,0,0,0,0,0,0,0,0,0,0,0,0,0,0,0
Danny Welbeck,29,Premier League,Forward,Watford,816,367,449,18,8,10,2,1,1,0,0,12,3,9,0,0.22,0,0.22,0.25,0.2,408,45,0
Darnell Johnson,22,Premier League,Defender,Leicester City,0,0,0,0,0,0,0,0,0,0,0,0,0,0,0,0,0,0,0,0,0,0,0
Darren Randolph,33,Premier League,Goalkeeper,West Ham United,180,90,90,2,1,1,0,0,0,0,0,5,1,4,0,0,0,0,0,0,0,90,0
Daryl Janmaat,31,Premier League,Defender,Watford,608,267,341,8,4,4,0,0,0,1,0,5,2,3,1,0.15,0.15,0,0,0,0,76,608
David Brooks,23,Premier League,Forward,AFC Bournemouth,513,316,197,9,5,4,1,0,1,0,0,12,7,5,1,0.18,0,0.18,0,0.46,513,57,0
David Button,31,Premier League,Goalkeeper,Brighton & Hove Albion,0,0,0,0,0,0,0,0,0,0,0,0,0,0,0,0,0,0,0,0,0,0,0
David de Gea,30,Premier League,Goalkeeper,Manchester United,3420,1710,1710,38,19,19,0,0,0,0,0,32,15,17,2,0,0,0,0,0,0,90,0
David Luiz,33,Premier League,Defender,Arsenal,2852,1620,1232,33,18,15,2,2,0,1,0,39,21,18,7,0.09,0.03,0.06,0.11,0,1426,86,2852
David Martin,34,Premier League,Goalkeeper,West Ham United,435,90,345,5,1,4,0,0,0,0,0,6,3,3,1,0,0,0,0,0,0,87,0
David McGoldrick,32,Premier League,Forward,Sheffield United,1825,1000,825,28,15,13,2,2,0,2,0,18,6,12,2,0.2,0.1,0.1,0.18,0,913,65,913
David Silva,34,Premier League,Midfielder,Manchester City,1833,1122,711,27,16,11,6,5,1,10,0,14,6,8,0,0.79,0.49,0.29,0.4,0.13,306,68,183
Davinson Sánchez Mina,24,Premier League,Defender,Tottenham Hotspur,2430,1306,1124,29,15,14,0,0,0,0,0,34,14,20,6,0,0,0,0,0,0,84,0
Davy Pröpper,29,Premier League,Midfielder,Brighton & Hove Albion,2830,1453,1377,35,18,17,1,1,0,2,0,43,22,21,4,0.1,0.06,0.03,0.06,0,2830,81,1415
Dean Henderson,23,Premier League,Goalkeeper,Sheffield United,3240,1620,1620,36,18,18,0,0,0,0,0,32,11,21,2,0,0,0,0,0,0,90,0
DeAndre Yedlin,27,Premier League,Defender,Newcastle United,934,514,420,16,9,7,1,1,0,0,0,14,6,8,3,0.1,0,0.1,0.18,0,934,58,0
Declan Rice,21,Premier League,Midfielder,West Ham United,3420,1710,1710,38,19,19,1,1,0,3,0,59,32,27,6,0.11,0.08,0.03,0.05,0,3420,90,1140
Dejan Lovren,31,Premier League,Defender,Liverpool,777,450,327,10,5,5,0,0,0,1,0,11,6,5,1,0.12,0.12,0,0,0,0,78,777
Dele Alli,24,Premier League,Midfielder,Tottenham Hotspur,1853,916,937,25,11,14,8,5,3,4,1,24,10,14,2,0.58,0.19,0.39,0.49,0.29,232,74,463
Demarai Gray,24,Premier League,Midfielder,Leicester City,607,271,336,21,10,11,2,1,1,3,0,4,1,3,1,0.74,0.44,0.3,0.33,0.27,304,29,202
Dennis Cirkin,18,Premier League,Midfielder,Tottenham Hotspur,0,0,0,0,0,0,0,0,0,0,0,0,0,0,0,0,0,0,0,0,0,0,0
Dennis Praet,26,Premier League,Midfielder,Leicester City,1131,588,543,27,13,14,1,1,0,2,0,16,5,11,2,0.24,0.16,0.08,0.15,0,1131,42,566
Dennis Srbeny,26,Premier League,Forward,Norwich City,39,33,6,8,5,3,1,0,1,0,0,1,1,0,0,2.31,0,2.31,0,15,39,5,0
Diego Rico,27,Premier League,Defender,AFC Bournemouth,2336,1170,1166,27,13,14,0,0,0,4,0,37,14,23,6,0.15,0.15,0,0,0,0,87,584
Dimitri Foulquier,27,Premier League,Defender,Watford,58,17,41,3,1,2,0,0,0,0,0,6,0,6,0,0,0,0,0,0,0,19,0
Diogo José Teixeira da Silva,23,Premier League,Midfielder,Wolverhampton Wanderers,2298,1086,1212,34,17,17,7,3,4,1,0,25,12,13,4,0.31,0.04,0.27,0.25,0.3,328,68,2298
Divock Origi,25,Premier League,Forward,Liverpool,704,299,405,28,13,15,4,3,1,1,0,12,6,6,1,0.64,0.13,0.51,0.9,0.22,176,25,704
Djibril Sidibé,28,Premier League,Defender,Everton,1820,898,922,25,12,13,0,0,0,4,0,26,6,20,3,0.2,0.2,0,0,0,0,73,455
Domingos Quina,20,Premier League,Midfielder,Watford,18,4,14,4,1,3,0,0,0,0,0,0,0,0,0,0,0,0,0,0,0,5,0
Dominic Calvert-Lewin,23,Premier League,Forward,Everton,2630,1195,1435,36,17,19,13,7,6,1,0,38,10,28,9,0.48,0.03,0.44,0.53,0.38,202,73,2630
Dominic Solanke,23,Premier League,Forward,AFC Bournemouth,1643,773,870,32,13,19,3,2,1,1,0,37,15,22,1,0.22,0.05,0.16,0.23,0.1,548,51,1643
Douglas Luiz,22,Premier League,Midfielder,Aston Villa,2608,1359,1249,36,18,18,3,2,1,2,0,48,22,26,8,0.17,0.07,0.1,0.13,0.07,869,72,1304
Dwight Gayle,30,Premier League,Forward,Newcastle United,848,372,476,20,9,11,4,2,2,2,0,14,8,6,2,0.64,0.21,0.42,0.48,0.38,212,42,424
Dwight McNeil,20,Premier League,Forward,Burnley,3345,1678,1667,38,19,19,2,2,0,6,0,47,21,26,5,0.22,0.16,0.05,0.11,0,1673,88,558
Ederson,27,Premier League,Goalkeeper,Manchester City,3072,1530,1542,35,17,18,0,0,0,0,0,24,10,14,4,0,0,0,0,0,0,88,0
Edward Nketiah,21,Premier League,Forward,Arsenal,648,316,332,13,7,6,2,1,1,0,0,8,5,3,1,0.28,0,0.28,0.28,0.27,324,50,0
Ellis Simms,19,Premier League,Midfielder,Everton,0,0,0,0,0,0,0,0,0,0,0,0,0,0,0,0,0,0,0,0,0,0,0
Emerson Palmieri dos Santos,26,Premier League,Defender,Chelsea,1025,645,380,15,8,7,0,0,0,0,0,20,10,10,3,0,0,0,0,0,0,68,0
Emil Krafth,26,Premier League,Defender,Newcastle United,1018,374,644,17,6,11,0,0,0,1,0,20,6,14,0,0.09,0.09,0,0,0,0,60,1018
Emile Smith Rowe,20,Premier League,Midfielder,Arsenal,97,31,66,2,1,1,0,0,0,0,0,0,0,0,0,0,0,0,0,0,0,49,0
Emiliano Buendía,23,Premier League,Midfielder,Norwich City,2465,1353,1112,36,19,17,1,0,1,7,0,50,28,22,7,0.29,0.26,0.04,0,0.08,2465,68,352
Enda Stevens,30,Premier League,Defender,Sheffield United,3347,1637,1710,38,19,19,2,1,1,4,0,38,14,24,7,0.16,0.11,0.05,0.05,0.05,1674,88,837
Eric Bertrand Bailly,26,Premier League,Defender,Manchester United,147,56,91,4,2,2,0,0,0,0,0,1,1,0,0,0,0,0,0,0,0,37,0
Eric Dier,26,Premier League,Midfielder,Tottenham Hotspur,1342,742,600,19,12,7,0,0,0,2,0,21,9,12,5,0.13,0.13,0,0,0,0,71,671
Eric García Martret,19,Premier League,Defender,Manchester City,790,477,313,13,7,6,0,0,0,0,0,7,2,5,1,0,0,0,0,0,0,61,0
Erik Lamela,28,Premier League,Midfielder,Tottenham Hotspur,1210,518,692,25,13,12,2,1,1,1,0,12,2,10,3,0.22,0.07,0.15,0.17,0.13,605,48,1210
Erik Pieters,32,Premier League,Defender,Burnley,1879,928,951,24,12,12,0,0,0,4,0,34,17,17,2,0.19,0.19,0,0,0,0,78,470
Etienne Capoue,32,Premier League,Midfielder,Watford,2632,1321,1311,30,15,15,0,0,0,3,0,44,19,25,8,0.1,0.1,0,0,0,0,88,877
Ezri Konsa Ngoyo,22,Premier League,Midfielder,Aston Villa,2043,1036,1007,25,12,13,1,0,1,2,0,38,18,20,3,0.13,0.09,0.04,0,0.09,2043,82,1022
Fabián Cornelio Balbuena González,29,Premier League,Defender,West Ham United,1173,540,633,17,8,9,1,1,0,0,0,22,13,9,2,0.08,0,0.08,0.17,0,1173,69,0
Fabian Delph,30,Premier League,Midfielder,Everton,1190,630,560,16,8,8,0,0,0,0,0,21,8,13,5,0,0,0,0,0,0,74,0
Fabian Schär,28,Premier League,Defender,Newcastle United,1671,764,907,22,10,12,2,2,0,0,0,33,10,23,5,0.11,0,0.11,0.24,0,836,76,0
Fabinho,27,Premier League,Midfielder,Liverpool,2074,1148,926,28,14,14,2,2,0,3,0,26,13,13,6,0.22,0.13,0.09,0.16,0,1037,74,691
Faustino Anjorin,18,Premier League,Defender,Chelsea,19,19,0,1,1,0,0,0,0,0,0,0,0,0,0,0,0,0,0,0,0,19,0
Faustino Marcos Alberto Rojo,30,Premier League,Defender,Manchester United,120,90,30,3,2,1,0,0,0,0,0,2,1,1,1,0,0,0,0,0,0,40,0
Federico Fernández,31,Premier League,Defender,Newcastle United,2618,1355,1263,32,16,16,2,1,1,2,0,38,18,20,8,0.14,0.07,0.07,0.07,0.07,1309,82,1309
Felipe Anderson Pereira Gomes,27,Premier League,Midfielder,West Ham United,1506,814,692,25,13,12,1,1,0,4,0,26,14,12,1,0.3,0.24,0.06,0.11,0,1506,60,377
Fernando Luiz Rosa,35,Premier League,Midfielder,Manchester City,2398,1165,1233,30,15,15,0,0,0,1,0,23,9,14,10,0.04,0.04,0,0,0,0,80,2398
Fikayo Tomori,22,Premier League,Defender,Chelsea,1293,630,663,15,7,8,1,0,1,0,0,18,7,11,3,0.07,0,0.07,0,0.14,1293,86,0
Filip Benković,23,Premier League,Defender,Leicester City,0,0,0,0,0,0,0,0,0,0,0,0,0,0,0,0,0,0,0,0,0,0,0
Florian Lejeune,29,Premier League,Defender,Newcastle United,441,254,187,6,3,3,2,0,2,0,0,10,5,5,0,0.41,0,0.41,0,0.96,221,74,0
Florin Andone,27,Premier League,Forward,Brighton & Hove Albion,72,46,26,3,2,1,1,0,1,0,0,0,0,0,1,1.25,0,1.25,0,3.46,72,24,0
Francisco Femenía Far,29,Premier League,Midfielder,Watford,2241,1221,1020,28,15,13,0,0,0,0,0,44,19,25,5,0,0,0,0,0,0,80,0
Fraser Forster,32,Premier League,Goalkeeper,Southampton,0,0,0,0,0,0,0,0,0,0,0,0,0,0,0,0,0,0,0,0,0,0,0
Frédéric Guilbert,25,Premier League,Defender,Aston Villa,2041,861,1180,25,11,14,0,0,0,2,0,34,9,25,7,0.09,0.09,0,0,0,0,82,1021
Frederico Rodrigues Santos,27,Premier League,Midfielder,Manchester United,2159,1068,1091,29,15,14,0,0,0,0,0,23,9,14,8,0,0,0,0,0,0,74,0
Gabriel Jesus,23,Premier League,Forward,Manchester City,2026,987,1039,34,17,17,14,6,8,7,0,10,5,5,3,0.93,0.31,0.62,0.55,0.69,145,60,289
Gabriel Teodoro Martinelli Silva,19,Premier League,Midfielder,Arsenal,656,257,399,14,6,8,3,1,2,0,0,9,6,3,1,0.41,0,0.41,0.35,0.45,219,47,0
Gaëtan Bong Songo,32,Premier League,Defender,Brighton & Hove Albion,55,2,53,4,2,2,0,0,0,0,0,2,0,2,0,0,0,0,0,0,0,14,0
Gary Cahill,34,Premier League,Defender,Crystal Palace,2168,1088,1080,25,13,12,0,0,0,1,0,33,12,21,1,0.04,0.04,0,0,0,0,87,2168
Gavin Kilkenny,20,Premier League,Midfielder,AFC Bournemouth,0,0,0,0,0,0,0,0,0,0,0,0,0,0,0,0,0,0,0,0,0,0,0
Gedson Carvalho Fernandes,21,Premier League,Midfielder,Tottenham Hotspur,61,44,17,7,4,3,0,0,0,0,0,1,1,0,0,0,0,0,0,0,0,9,0
George Baldock,27,Premier League,Defender,Sheffield United,3420,1710,1710,38,19,19,2,0,2,3,0,38,14,24,7,0.13,0.08,0.05,0,0.11,1710,90,1140
George Hirst,21,Premier League,Forward,Leicester City,9,2,7,2,1,1,0,0,0,0,0,0,0,0,0,0,0,0,0,0,0,5,0
Georges-Kevin N'Koudou Mbida,25,Premier League,Forward,Tottenham Hotspur,2,2,0,1,1,0,0,0,0,0,0,0,0,0,0,0,0,0,0,0,0,2,0
Georginio Wijnaldum,29,Premier League,Midfielder,Liverpool,2948,1520,1428,37,19,18,4,3,1,0,0,28,13,15,0,0.12,0,0.12,0.18,0.06,737,80,0
Gerard Deulofeu,26,Premier League,Forward,Watford,2109,1063,1046,28,14,14,4,2,2,5,1,32,14,18,3,0.38,0.21,0.17,0.17,0.17,527,75,422
Giovani Lo Celso,24,Premier League,Midfielder,Tottenham Hotspur,1487,806,681,28,13,15,0,0,0,2,0,16,7,9,6,0.12,0.12,0,0,0,0,53,744
Giovanni McGregor,0,Premier League,Midfielder,Crystal Palace,0,0,0,0,0,0,0,0,0,0,0,0,0,0,0,0,0,0,0,0,0,0,0
Glenn Murray,37,Premier League,Forward,Brighton & Hove Albion,786,394,392,23,13,10,1,0,1,1,0,9,3,6,0,0.23,0.11,0.11,0,0.23,786,34,786
Gonçalo Bento Soares Cardoso,20,Premier League,Defender,West Ham United,0,0,0,0,0,0,0,0,0,0,0,0,0,0,0,0,0,0,0,0,0,0,0
Granit Xhaka,28,Premier League,Midfielder,Arsenal,2590,1213,1377,31,14,17,1,1,0,2,0,31,15,16,10,0.1,0.07,0.03,0.07,0,2590,84,1295
Grant Hanley,28,Premier League,Defender,Norwich City,1262,642,620,15,8,7,0,0,0,0,0,24,9,15,4,0,0,0,0,0,0,84,0
Gylfi Sigurdsson,31,Premier League,Midfielder,Everton,2562,1270,1292,35,18,17,2,2,0,3,1,41,15,26,3,0.18,0.11,0.07,0.14,0,1281,73,854
Hamza Choudhury,23,Premier League,Midfielder,Leicester City,889,405,484,20,11,9,1,0,1,1,0,10,6,4,4,0.2,0.1,0.1,0,0.19,889,44,889
Harry Kane,27,Premier League,Forward,Tottenham Hotspur,2590,1345,1245,29,15,14,18,9,9,2,2,34,11,23,4,0.69,0.07,0.63,0.6,0.65,144,89,1295
Harry Lewis,22,Premier League,Goalkeeper,Southampton,0,0,0,0,0,0,0,0,0,0,0,0,0,0,0,0,0,0,0,0,0,0,0
Harry Maguire,27,Premier League,Defender,Manchester United,3420,1710,1710,38,19,19,1,0,1,1,0,32,15,17,6,0.05,0.03,0.03,0,0.05,3420,90,3420
Harry Wilson,23,Premier League,Midfielder,AFC Bournemouth,1653,808,845,31,14,17,7,2,5,0,0,31,14,17,2,0.38,0,0.38,0.22,0.53,236,53,0
Harry Winks,24,Premier League,Midfielder,Tottenham Hotspur,2226,1183,1043,31,17,14,0,0,0,0,0,29,12,17,9,0,0,0,0,0,0,72,0
Harvey Elliot,0,Premier League,Forward,Liverpool,6,6,0,2,2,0,0,0,0,0,0,0,0,0,0,0,0,0,0,0,0,3,0
Harvey Lewis Barnes,22,Premier League,Midfielder,Leicester City,2091,1151,940,36,19,17,6,4,2,8,0,23,10,13,0,0.6,0.34,0.26,0.31,0.19,349,58,261
Harvey White,19,Premier League,Midfielder,Tottenham Hotspur,0,0,0,0,0,0,0,0,0,0,0,0,0,0,0,0,0,0,0,0,0,0,0
Hector Bellerin,25,Premier League,Defender,Arsenal,1159,521,638,15,7,8,1,0,1,0,0,16,7,9,2,0.08,0,0.08,0,0.14,1159,77,0
Henri Lansbury,30,Premier League,Midfielder,Aston Villa,188,11,177,10,4,6,0,0,0,0,0,6,1,5,0,0,0,0,0,0,0,19,0
Henrikh Mkhitaryan,31,Premier League,Midfielder,Arsenal,111,23,88,3,1,2,0,0,0,0,0,0,0,0,1,0,0,0,0,0,0,37,0
Heung-Min Son,28,Premier League,Forward,Tottenham Hotspur,2485,1321,1164,30,16,14,11,7,4,10,0,30,10,20,2,0.76,0.36,0.4,0.48,0.31,226,83,249
Heurelho da Silva Gomes,39,Premier League,Goalkeeper,Watford,0,0,0,0,0,0,0,0,0,0,0,0,0,0,0,0,0,0,0,0,0,0,0
Hugo Lloris,33,Premier League,Goalkeeper,Tottenham Hotspur,1808,990,818,21,11,10,0,0,0,0,0,21,6,15,0,0,0,0,0,0,0,86,0
Ibrahim Amadou,27,Premier League,Midfielder,Norwich City,757,360,397,11,4,7,0,0,0,0,0,19,12,7,1,0,0,0,0,0,0,69,0
Ignacio Pussetto,24,Premier League,Midfielder,Watford,67,28,39,7,4,3,0,0,0,0,0,1,1,0,1,0,0,0,0,0,0,10,0
İlkay Gündoğan,30,Premier League,Midfielder,Manchester City,2015,1057,958,31,17,14,2,2,0,1,1,24,7,17,7,0.13,0.04,0.09,0.17,0,1008,65,2015
Indiana Vassilev,19,Premier League,Midfielder,Aston Villa,47,19,28,4,2,2,0,0,0,0,0,1,0,1,0,0,0,0,0,0,0,12,0
Isaac Ajayi Success,24,Premier League,Forward,Watford,65,33,32,5,3,2,0,0,0,0,0,1,1,0,1,0,0,0,0,0,0,13,0
Isaac Hayden,25,Premier League,Midfielder,Newcastle United,2226,1260,966,29,16,13,1,1,0,2,0,28,14,14,5,0.12,0.08,0.04,0.07,0,2226,77,1113
Ismaïla Sarr,22,Premier League,Midfielder,Watford,2030,1066,964,28,15,13,5,4,1,4,0,32,12,20,1,0.4,0.18,0.22,0.34,0.09,406,73,508
Issa Diop,23,Premier League,Defender,West Ham United,2766,1504,1262,32,17,15,3,2,1,1,0,52,29,23,8,0.13,0.03,0.1,0.12,0.07,922,86,2766
Jack Cork,31,Premier League,Midfielder,Burnley,2618,1346,1272,30,15,15,0,0,0,0,0,40,18,22,1,0,0,0,0,0,0,87,0
Jack Grealish,25,Premier League,Midfielder,Aston Villa,3234,1620,1614,36,18,18,8,3,5,6,0,60,27,33,8,0.39,0.17,0.22,0.17,0.28,404,90,539
Jack O'Connell,26,Premier League,Defender,Sheffield United,2915,1620,1295,33,18,15,0,0,0,1,0,28,14,14,4,0.03,0.03,0,0,0,0,88,2915
Jack Robinson,27,Premier League,Defender,Sheffield United,505,90,415,6,1,5,0,0,0,0,0,10,0,10,0,0,0,0,0,0,0,84,0
Jack Rodwell,29,Premier League,Midfielder,Sheffield United,15,0,15,1,0,1,0,0,0,0,0,0,0,0,0,0,0,0,0,0,0,15,0
Jack Simpson,23,Premier League,Defender,AFC Bournemouth,238,145,93,4,2,2,0,0,0,0,0,5,3,2,0,0,0,0,0,0,0,60,0
Jack Stacey,24,Premier League,Midfielder,AFC Bournemouth,1550,746,804,19,9,10,0,0,0,2,0,26,11,15,2,0.12,0.12,0,0,0,0,82,775
Jack Stephens,26,Premier League,Defender,Southampton,2452,1209,1243,28,14,14,1,0,1,3,0,35,17,18,5,0.15,0.11,0.04,0,0.07,2452,88,817
Jack Wilshere,28,Premier League,Midfielder,West Ham United,211,110,101,8,4,4,0,0,0,0,0,4,4,0,0,0,0,0,0,0,0,26,0
Jack Young,0,Premier League,Forward,Newcastle United,0,0,0,0,0,0,0,0,0,0,0,0,0,0,0,0,0,0,0,0,0,0,0
Jacob Maddox,22,Premier League,Midfielder,Southampton,0,0,0,0,0,0,0,0,0,0,0,0,0,0,0,0,0,0,0,0,0,0,0
Jaïro Riedewald,24,Premier League,Defender,Crystal Palace,763,279,484,17,7,10,0,0,0,0,0,9,3,6,0,0,0,0,0,0,0,45,0
Jake Eastwood,24,Premier League,Goalkeeper,Sheffield United,0,0,0,0,0,0,0,0,0,0,0,0,0,0,0,0,0,0,0,0,0,0,0
Jake Vokins,20,Premier League,Defender,Southampton,90,90,0,1,1,0,0,0,0,0,0,1,1,0,0,0,0,0,0,0,0,90,0
Jamal Lascelles,27,Premier League,Defender,Newcastle United,2079,1010,1069,24,12,12,1,1,0,0,0,26,7,19,5,0.04,0,0.04,0.09,0,2079,87,0
Jamal Lewis,22,Premier League,Midfielder,Norwich City,2304,1214,1090,28,15,13,1,1,0,0,0,54,28,26,4,0.04,0,0.04,0.07,0,2304,82,0
James Chester,31,Premier League,Defender,Aston Villa,0,0,0,0,0,0,0,0,0,0,0,0,0,0,0,0,0,0,0,0,0,0,0
James Daly,20,Premier League,Forward,Crystal Palace,0,0,0,0,0,0,0,0,0,0,0,0,0,0,0,0,0,0,0,0,0,0,0
James Garner,19,Premier League,Defender,Manchester United,8,0,8,1,0,1,0,0,0,0,0,1,0,1,0,0,0,0,0,0,0,8,0
James Justin,21,Premier League,Midfielder,Leicester City,1010,460,550,13,6,7,0,0,0,1,0,12,1,11,1,0.09,0.09,0,0,0,0,78,1010
James Maddison,23,Premier League,Midfielder,Leicester City,2628,1315,1313,31,15,16,6,3,3,3,0,25,14,11,4,0.31,0.1,0.21,0.21,0.21,438,85,876
James McArthur,33,Premier League,Midfielder,Crystal Palace,3105,1607,1498,37,19,18,0,0,0,3,0,38,17,21,6,0.09,0.09,0,0,0,0,84,1035
James McCarthy,29,Premier League,Midfielder,Crystal Palace,1668,787,881,33,15,18,0,0,0,0,0,27,10,17,9,0,0,0,0,0,0,51,0
James Milner,34,Premier League,Midfielder,Liverpool,926,560,366,22,12,10,2,1,1,2,2,9,7,2,4,0.39,0.19,0.19,0.16,0.25,463,42,463
James Tarkowski,27,Premier League,Defender,Burnley,3420,1710,1710,38,19,19,2,1,1,2,0,48,22,26,10,0.11,0.05,0.05,0.05,0.05,1710,90,1710
James Tomkins,31,Premier League,Defender,Crystal Palace,1584,803,781,18,9,9,1,0,1,1,0,23,12,11,5,0.11,0.06,0.06,0,0.12,1584,88,1584
James Ward-Prowse,26,Premier League,Midfielder,Southampton,3420,1710,1710,38,19,19,5,2,3,3,1,56,33,23,9,0.21,0.08,0.13,0.11,0.16,684,90,1140
Jamie Vardy,33,Premier League,Forward,Leicester City,3034,1594,1440,35,19,16,23,12,11,5,4,35,15,20,2,0.83,0.15,0.68,0.68,0.69,132,87,607
Jan Bednarek,24,Premier League,Defender,Southampton,3058,1530,1528,34,17,17,1,1,0,1,0,53,30,23,4,0.06,0.03,0.03,0.06,0,3058,90,3058
Jan Vertonghen,33,Premier League,Defender,Tottenham Hotspur,1644,689,955,23,9,14,1,0,1,1,0,23,7,16,2,0.11,0.05,0.05,0,0.09,1644,71,1644
Jannik Vestergaard,28,Premier League,Defender,Southampton,1497,676,821,19,9,10,1,1,0,0,0,25,16,9,3,0.06,0,0.06,0.13,0,1497,79,0
Japhet Tanganga,21,Premier League,Defender,Tottenham Hotspur,526,256,270,6,3,3,0,0,0,0,0,7,4,3,1,0,0,0,0,0,0,88,0
Jarrad Branthwaite,18,Premier League,Midfielder,Everton,298,164,134,4,2,2,0,0,0,0,0,5,4,1,0,0,0,0,0,0,0,75,0
Jarrod Bowen,23,Premier League,Forward,West Ham United,922,463,459,13,6,7,1,1,0,4,0,13,7,6,0,0.49,0.39,0.1,0.19,0,922,71,231
Javier Hernandez,32,Premier League,Forward,West Ham United,107,24,83,2,1,1,1,0,1,0,0,3,2,1,0,0.84,0,0.84,0,1.08,107,54,0
Javier Manquillo Gaitán,26,Premier League,Defender,Newcastle United,1599,957,642,21,12,9,0,0,0,1,0,20,12,8,5,0.06,0.06,0,0,0,0,76,1599
Jay Rodriguez,31,Premier League,Forward,Burnley,2007,927,1080,36,19,17,8,3,5,1,1,32,13,19,1,0.4,0.04,0.36,0.29,0.42,251,56,2007
Jean-Philippe Gbamin,25,Premier League,Midfielder,Everton,135,90,45,2,1,1,0,0,0,0,0,0,0,0,0,0,0,0,0,0,0,68,0
Jed Steer,28,Premier League,Goalkeeper,Aston Villa,8,0,8,1,0,1,0,0,0,0,0,0,0,0,0,0,0,0,0,0,0,8,0
Jeff Hendrick,28,Premier League,Midfielder,Burnley,1935,1042,893,24,12,12,2,1,1,2,0,29,13,16,8,0.19,0.09,0.09,0.09,0.1,968,81,968
Jefferson Lerma,26,Premier League,Midfielder,AFC Bournemouth,2708,1404,1304,33,18,15,1,1,0,2,0,48,22,26,13,0.1,0.07,0.03,0.06,0,2708,82,1354
Jeffrey Schlupp,27,Premier League,Defender,Crystal Palace,1035,591,444,17,9,8,3,2,1,1,0,15,7,8,2,0.35,0.09,0.26,0.3,0.2,345,61,1035
Jeremy Ngakia,20,Premier League,Forward,West Ham United,441,261,180,5,3,2,0,0,0,0,0,8,4,4,0,0,0,0,0,0,0,88,0
Jesse Lingard,27,Premier League,Midfielder,Manchester United,931,454,477,22,10,12,1,0,1,0,0,13,4,9,3,0.1,0,0.1,0,0.19,931,42,0
Jesús Vallejo Lázaro,23,Premier League,Defender,Wolverhampton Wanderers,162,162,0,2,2,0,0,0,0,0,0,5,5,0,1,0,0,0,0,0,0,81,0
Jetro Willems,26,Premier League,Defender,Newcastle United,1498,800,698,19,11,8,2,1,1,2,0,24,11,13,0,0.24,0.12,0.12,0.11,0.13,749,79,749
Jimmy Dunne,23,Premier League,Defender,Burnley,0,0,0,0,0,0,0,0,0,0,0,0,0,0,0,0,0,0,0,0,0,0,0
João Cancelo,26,Premier League,Defender,Manchester City,1205,729,476,17,10,7,0,0,0,0,0,7,4,3,4,0,0,0,0,0,0,71,0
João Manuel Neves Virginia,21,Premier League,Goalkeeper,Everton,0,0,0,0,0,0,0,0,0,0,0,0,0,0,0,0,0,0,0,0,0,0,0
João Moutinho,34,Premier League,Midfielder,Wolverhampton Wanderers,3108,1516,1592,38,19,19,1,0,1,6,0,31,16,15,7,0.2,0.17,0.03,0,0.06,3108,82,518
João Pedro Junqueira de Jesus,19,Premier League,Forward,Watford,22,16,6,3,1,2,0,0,0,0,0,1,1,0,0,0,0,0,0,0,0,7,0
Joe Gomez,23,Premier League,Defender,Liverpool,1999,1095,904,28,15,13,0,0,0,0,0,16,8,8,7,0,0,0,0,0,0,71,0
Joe Hart,33,Premier League,Goalkeeper,Burnley,0,0,0,0,0,0,0,0,0,0,0,0,0,0,0,0,0,0,0,0,0,0,0
Joel Matip,29,Premier League,Defender,Liverpool,703,180,523,9,3,6,1,1,0,0,0,5,2,3,0,0.13,0,0.13,0.5,0,703,78,0
Joel Mumbongo,21,Premier League,Forward,Burnley,0,0,0,0,0,0,0,0,0,0,0,0,0,0,0,0,0,0,0,0,0,0,0
Joel Ward,31,Premier League,Defender,Crystal Palace,2383,1268,1115,29,15,14,0,0,0,0,0,34,13,21,4,0,0,0,0,0,0,82,0
Joelinton Cassio Apolinário de Lira,24,Premier League,Forward,Newcastle United,2698,1410,1288,38,19,19,2,1,1,2,0,43,15,28,7,0.13,0.07,0.07,0.06,0.07,1349,71,1349
Johann Berg Guðmunds­son,30,Premier League,Midfielder,Burnley,620,375,245,12,7,5,1,1,0,1,0,6,3,3,0,0.29,0.15,0.15,0.24,0,620,52,620
John Egan,28,Premier League,Defender,Sheffield United,3189,1609,1580,36,18,18,2,1,1,0,0,29,11,18,5,0.06,0,0.06,0.06,0.06,1595,89,0
John Fleck,29,Premier League,Midfielder,Sheffield United,2516,1229,1287,30,15,15,5,4,1,2,0,30,11,19,8,0.25,0.07,0.18,0.29,0.07,503,84,1258
John Lundstram,26,Premier League,Midfielder,Sheffield United,2455,1140,1315,34,17,17,5,4,1,3,0,29,10,19,5,0.29,0.11,0.18,0.32,0.07,491,72,818
John McGinn,26,Premier League,Midfielder,Aston Villa,2317,1160,1157,28,15,13,3,1,2,3,0,39,16,23,3,0.23,0.12,0.12,0.08,0.16,772,83,772
John Ruddy,34,Premier League,Goalkeeper,Wolverhampton Wanderers,0,0,0,0,0,0,0,0,0,0,0,0,0,0,0,0,0,0,0,0,0,0,0
John Stones,26,Premier League,Defender,Manchester City,1119,624,495,16,8,8,0,0,0,0,0,14,6,8,0,0,0,0,0,0,0,70,0
John-Kymani Gordon,17,Premier League,Forward,Crystal Palace,0,0,0,0,0,0,0,0,0,0,0,0,0,0,0,0,0,0,0,0,0,0,0
Jonas Lössl,31,Premier League,Goalkeeper,Everton,0,0,0,0,0,0,0,0,0,0,0,0,0,0,0,0,0,0,0,0,0,0,0
Jonathan Kodjia,31,Premier League,Forward,Aston Villa,112,38,74,6,2,4,0,0,0,0,0,4,1,3,1,0,0,0,0,0,0,19,0
Jonjo Shelvey,28,Premier League,Midfielder,Newcastle United,2124,1248,876,26,16,10,6,3,3,2,0,31,16,15,3,0.34,0.08,0.25,0.22,0.31,354,82,1062
Jonny,26,Premier League,Defender,Wolverhampton Wanderers,2891,1593,1298,35,18,17,2,1,1,2,0,30,16,14,4,0.12,0.06,0.06,0.06,0.07,1446,83,1446
Jonny Evans,32,Premier League,Defender,Leicester City,3386,1710,1676,38,19,19,1,0,1,1,0,38,16,22,9,0.05,0.03,0.03,0,0.05,3386,89,3386
Jordan Ayew,29,Premier League,Forward,Crystal Palace,3162,1624,1538,37,19,18,9,4,5,2,0,44,17,27,6,0.31,0.06,0.26,0.22,0.29,351,85,1581
Jordan Henderson,30,Premier League,Midfielder,Liverpool,2244,992,1252,30,14,16,4,2,2,5,0,14,5,9,2,0.36,0.2,0.16,0.18,0.14,561,75,449
Jordan Pickford,26,Premier League,Goalkeeper,Everton,3420,1710,1710,38,19,19,0,0,0,0,0,49,18,31,2,0,0,0,0,0,0,90,0
Jordan Thomas,19,Premier League,Defender,Norwich City,0,0,0,1,0,1,0,0,0,0,0,0,0,0,0,0,0,0,0,0,0,0,0
Jordon Ibe,24,Premier League,Midfielder,AFC Bournemouth,48,22,26,2,1,1,0,0,0,0,0,1,0,1,0,0,0,0,0,0,0,24,0
Jorginho,28,Premier League,Midfielder,Chelsea,2383,1200,1183,31,15,16,4,3,1,2,3,39,13,26,10,0.23,0.08,0.15,0.23,0.08,596,77,1192
José Ángel Esmoris Tasende,23,Premier League,Defender,Manchester City,421,241,180,6,4,2,0,0,0,0,0,7,3,4,1,0,0,0,0,0,0,70,0
José Diogo Dalot Teixeira,21,Premier League,Defender,Manchester United,65,2,63,4,1,3,0,0,0,0,0,0,0,0,0,0,0,0,0,0,0,16,0
José Holebas,36,Premier League,Defender,Watford,1024,486,538,14,8,6,0,0,0,0,0,26,12,14,5,0,0,0,0,0,0,73,0
José Ignacio Peleteiro Ramallo,29,Premier League,Midfielder,Aston Villa,333,167,166,10,5,5,0,0,0,1,0,4,0,4,0,0.27,0.27,0,0,0,0,33,333
Joseph Anang,0,Premier League,Midfielder,West Ham United,0,0,0,0,0,0,0,0,0,0,0,0,0,0,0,0,0,0,0,0,0,0,0
Joseph Willock,21,Premier League,Midfielder,Arsenal,844,340,504,29,12,17,1,0,1,1,0,15,6,9,2,0.21,0.11,0.11,0,0.18,844,29,844
Josh Benson,20,Premier League,Midfielder,Burnley,0,0,0,0,0,0,0,0,0,0,0,0,0,0,0,0,0,0,0,0,0,0,0
Josh Brownhill,24,Premier League,Midfielder,Burnley,805,355,450,10,5,5,0,0,0,0,0,10,4,6,2,0,0,0,0,0,0,81,0
Josh Martin,0,Premier League,Midfielder,Norwich City,32,21,11,5,2,3,0,0,0,0,0,1,1,0,0,0,0,0,0,0,0,6,0
Joshua King,28,Premier League,Forward,AFC Bournemouth,2020,1000,1020,26,13,13,6,3,3,4,3,37,17,20,0,0.45,0.18,0.27,0.27,0.26,337,78,505
Josip Drmic,28,Premier League,Forward,Norwich City,635,352,283,21,10,11,1,1,0,0,0,10,6,4,1,0.14,0,0.14,0.26,0,635,30,0
Juan Marcos Foyth,22,Premier League,Defender,Tottenham Hotspur,66,18,48,4,1,3,0,0,0,0,0,2,1,1,1,0,0,0,0,0,0,17,0
Juan Mata,32,Premier League,Midfielder,Manchester United,753,468,285,19,11,8,0,0,0,2,0,6,4,2,1,0.24,0.24,0,0,0,0,40,377
Junior Stanislas,30,Premier League,Midfielder,AFC Bournemouth,710,283,427,15,6,9,3,1,2,0,1,16,3,13,1,0.38,0,0.38,0.32,0.42,237,47,0
Jürgen Locadia,27,Premier League,Forward,Brighton & Hove Albion,86,22,64,2,1,1,0,0,0,0,0,0,0,0,0,0,0,0,0,0,0,43,0
Kaine Hayden,0,Premier League,Midfielder,Aston Villa,0,0,0,0,0,0,0,0,0,0,0,0,0,0,0,0,0,0,0,0,0,0,0
Karl Darlow,30,Premier League,Goalkeeper,Newcastle United,0,0,0,0,0,0,0,0,0,0,0,0,0,0,0,0,0,0,0,0,0,0,0
Kasper Schmeichel,34,Premier League,Goalkeeper,Leicester City,3420,1710,1710,38,19,19,0,0,0,0,0,38,16,22,2,0,0,0,0,0,0,90,0
Keinan Davis,22,Premier League,Midfielder,Aston Villa,538,291,247,18,10,8,0,0,0,0,0,7,1,6,0,0,0,0,0,0,0,30,0
Kelechi Iheanacho,24,Premier League,Forward,Leicester City,962,452,510,20,10,10,5,2,3,3,0,8,3,5,1,0.75,0.28,0.47,0.4,0.53,192,48,321
Kelland Watts,21,Premier League,Midfielder,Newcastle United,16,16,0,1,1,0,0,0,0,0,0,1,1,0,0,0,0,0,0,0,0,16,0
Ken Sema,27,Premier League,Midfielder,Watford,0,0,0,0,0,0,0,0,0,0,0,0,0,0,0,0,0,0,0,0,0,0,0
Kenny Mclean,28,Premier League,Midfielder,Norwich City,2966,1391,1575,37,18,19,1,1,0,1,0,60,28,32,5,0.06,0.03,0.03,0.06,0,2966,80,2966
Kepa Arrizabalaga,26,Premier League,Goalkeeper,Chelsea,2970,1440,1530,33,16,17,0,0,0,0,0,46,13,33,0,0,0,0,0,0,0,90,0
Kevin Danso,22,Premier League,Defender,Southampton,276,163,113,6,3,3,0,0,0,1,0,7,6,1,2,0.33,0.33,0,0,0,0,46,276
Kevin De Bruyne,29,Premier League,Midfielder,Manchester City,2800,1403,1397,35,17,18,13,9,4,20,2,21,9,12,3,1.06,0.64,0.42,0.58,0.26,215,80,140
Kevin Long,30,Premier League,Defender,Burnley,562,270,292,8,3,5,0,0,0,0,0,5,4,1,0,0,0,0,0,0,0,70,0
Ki-Jana Hoever,18,Premier League,Defender,Liverpool,0,0,0,0,0,0,0,0,0,0,0,0,0,0,0,0,0,0,0,0,0,0,0
Kieran Tierney,23,Premier League,Defender,Arsenal,992,630,362,15,8,7,1,1,0,1,0,14,10,4,2,0.18,0.09,0.09,0.14,0,992,66,992
Kieron Freeman,28,Premier League,Defender,Sheffield United,5,0,5,2,1,1,0,0,0,0,0,0,0,0,0,0,0,0,0,0,0,3,0
Konstantinos Mavropanos,22,Premier League,Defender,Arsenal,0,0,0,0,0,0,0,0,0,0,0,0,0,0,0,0,0,0,0,0,0,0,0
Kortney Hause,25,Premier League,Defender,Aston Villa,1544,810,734,18,9,9,1,1,0,0,0,32,18,14,3,0.06,0,0.06,0.11,0,1544,86,0
Kurt Zouma,26,Premier League,Defender,Chelsea,2342,1128,1214,28,14,14,0,0,0,0,0,37,8,29,6,0,0,0,0,0,0,84,0
Kyle Walker,30,Premier League,Defender,Manchester City,2397,1073,1324,29,14,15,1,1,0,4,0,24,6,18,5,0.19,0.15,0.04,0.08,0,2397,83,599
Kyle Walker-Peters,23,Premier League,Defender,Southampton,943,493,450,13,7,6,0,0,0,0,0,12,6,6,1,0,0,0,0,0,0,73,0
Leander Dendoncker,25,Premier League,Midfielder,Wolverhampton Wanderers,2794,1499,1295,38,19,19,4,3,1,0,0,30,13,17,5,0.13,0,0.13,0.18,0.07,699,74,0
Leandro Trossard,25,Premier League,Forward,Brighton & Hove Albion,2013,1256,757,31,17,14,5,4,1,3,0,33,21,12,0,0.36,0.13,0.22,0.29,0.12,403,65,671
Lee Grant,37,Premier League,Goalkeeper,Manchester United,0,0,0,0,0,0,0,0,0,0,0,0,0,0,0,0,0,0,0,0,0,0,0
Leighton Baines,35,Premier League,Defender,Everton,402,118,284,8,3,5,0,0,0,0,0,8,2,6,0,0,0,0,0,0,0,50,0
Leon Balogun,32,Premier League,Defender,Brighton & Hove Albion,0,0,0,0,0,0,0,0,0,0,0,0,0,0,0,0,0,0,0,0,0,0,0
Leon Clarke,35,Premier League,Forward,Sheffield United,33,13,20,2,1,1,0,0,0,0,0,2,0,2,0,0,0,0,0,0,0,17,0
Leonardo Campana Romero,20,Premier League,Forward,Wolverhampton Wanderers,0,0,0,0,0,0,0,0,0,0,0,0,0,0,0,0,0,0,0,0,0,0,0
Leroy Sané,24,Premier League,Midfielder,Manchester City,11,11,0,1,1,0,0,0,0,0,0,0,0,0,0,0,0,0,0,0,0,11,0
Lewis Bate,0,Premier League,Midfielder,Chelsea,0,0,0,0,0,0,0,0,0,0,0,0,0,0,0,0,0,0,0,0,0,0,0
Lewis Cook,23,Premier League,Midfielder,AFC Bournemouth,1345,693,652,27,15,12,0,0,0,0,0,28,10,18,5,0,0,0,0,0,0,50,0
Lewis Dunk,28,Premier League,Defender,Brighton & Hove Albion,3231,1611,1620,36,18,18,3,1,2,3,0,47,23,24,9,0.17,0.08,0.08,0.06,0.11,1077,90,1077
Lewis Jack Gibson,20,Premier League,Defender,Everton,0,0,0,0,0,0,0,0,0,0,0,0,0,0,0,0,0,0,0,0,0,0,0
Liam Gibson,23,Premier League,Defender,Newcastle United,0,0,0,0,0,0,0,0,0,0,0,0,0,0,0,0,0,0,0,0,0,0,0
Lloyd Kelly,22,Premier League,Defender,AFC Bournemouth,638,360,278,8,4,4,0,0,0,0,0,14,6,8,2,0,0,0,0,0,0,80,0
Lovre Kalinić,30,Premier League,Goalkeeper,Aston Villa,0,0,0,0,0,0,0,0,0,0,0,0,0,0,0,0,0,0,0,0,0,0,0
Lucas Digne,27,Premier League,Defender,Everton,3035,1570,1465,35,18,17,0,0,0,7,0,42,16,26,6,0.21,0.21,0,0,0,0,87,434
Lucas Rodrigues Moura da Silva,28,Premier League,Midfielder,Tottenham Hotspur,2246,1160,1086,35,17,18,4,1,3,4,0,27,12,15,3,0.32,0.16,0.16,0.08,0.25,562,64,562
Lucas Torreira,24,Premier League,Midfielder,Arsenal,1509,799,710,29,16,13,1,0,1,1,0,23,14,9,7,0.12,0.06,0.06,0,0.13,1509,52,1509
Luka Milivojević,29,Premier League,Midfielder,Crystal Palace,2514,1270,1244,31,16,15,3,1,2,1,2,36,15,21,12,0.14,0.04,0.11,0.07,0.14,838,81,2514
Lukas Jensen,0,Premier League,Goalkeeper,Burnley,0,0,0,0,0,0,0,0,0,0,0,0,0,0,0,0,0,0,0,0,0,0,0
Lukas Rupp,29,Premier League,Midfielder,Norwich City,698,210,488,12,6,6,0,0,0,0,0,17,4,13,1,0,0,0,0,0,0,58,0
Luke Cundle,0,Premier League,Midfielder,Wolverhampton Wanderers,0,0,0,0,0,0,0,0,0,0,0,0,0,0,0,0,0,0,0,0,0,0,0
Luke Freeman,28,Premier League,Forward,Sheffield United,360,178,182,11,4,7,0,0,0,0,0,5,2,3,2,0,0,0,0,0,0,33,0
Luke Shaw,25,Premier League,Defender,Manchester United,1734,864,870,24,13,11,0,0,0,0,0,15,6,9,7,0,0,0,0,0,0,72,0
Luke Thomas,0,Premier League,Midfielder,Leicester City,268,178,90,3,2,1,0,0,0,1,0,4,1,3,0,0.34,0.34,0,0,0,0,89,268
Lys Mousset,24,Premier League,Forward,Sheffield United,1232,524,708,30,14,16,6,3,3,4,0,14,3,11,1,0.73,0.29,0.44,0.52,0.38,205,41,308
Maarten Stekelenburg,38,Premier League,Goalkeeper,Everton,0,0,0,0,0,0,0,0,0,0,0,0,0,0,0,0,0,0,0,0,0,0,0
Mace Lewin Goodridge,21,Premier League,Midfielder,Burnley,0,0,0,0,0,0,0,0,0,0,0,0,0,0,0,0,0,0,0,0,0,0,0
Mahmoud Ibrahim Hassan,26,Premier League,Midfielder,Aston Villa,1951,880,1071,34,17,17,6,4,2,1,0,25,10,15,4,0.32,0.05,0.28,0.41,0.17,325,57,1951
Mamadou Sakho,30,Premier League,Defender,Crystal Palace,932,382,550,14,6,8,0,0,0,0,0,19,5,14,2,0,0,0,0,0,0,67,0
Manuel Lanzini,27,Premier League,Midfielder,West Ham United,1377,680,697,24,13,11,0,0,0,2,0,27,16,11,1,0.13,0.13,0,0,0,0,57,689
Marc Albrighton,30,Premier League,Midfielder,Leicester City,863,388,475,20,8,12,0,0,0,3,0,10,5,5,2,0.31,0.31,0,0,0,0,43,288
Marc Guehi,20,Premier League,Defender,Chelsea,0,0,0,0,0,0,0,0,0,0,0,0,0,0,0,0,0,0,0,0,0,0,0
Marco Stiepermann,29,Premier League,Midfielder,Norwich City,1184,585,599,24,10,14,0,0,0,0,0,32,17,15,6,0,0,0,0,0,0,49,0
Marcos Alonso,29,Premier League,Defender,Chelsea,1430,695,735,18,8,10,4,2,2,2,0,18,3,15,4,0.38,0.13,0.25,0.26,0.24,358,79,715
Marcus Rashford,23,Premier League,Forward,Manchester United,2655,1257,1398,31,15,16,17,12,5,7,6,26,12,14,3,0.81,0.24,0.58,0.86,0.32,156,86,379
Mario Vrančić,31,Premier League,Midfielder,Norwich City,626,403,223,20,12,8,1,1,0,0,0,17,9,8,3,0.14,0,0.14,0.22,0,626,31,0
Mark Noble,33,Premier League,Midfielder,West Ham United,2686,1286,1400,33,15,18,4,2,2,3,3,43,22,21,5,0.23,0.1,0.13,0.14,0.13,672,81,895
Mark Travers,21,Premier League,Goalkeeper,AFC Bournemouth,90,90,0,1,1,0,0,0,0,0,0,2,2,0,0,0,0,0,0,0,0,90,0
Martin Dúbravka,31,Premier League,Goalkeeper,Newcastle United,3420,1710,1710,38,19,19,0,0,0,0,0,51,20,31,0,0,0,0,0,0,0,90,0
Martin Kelly,30,Premier League,Defender,Crystal Palace,1550,701,849,19,9,10,0,0,0,1,0,16,6,10,0,0.06,0.06,0,0,0,0,82,1550
Martín Montoya,29,Premier League,Defender,Brighton & Hove Albion,1901,1006,895,27,14,13,0,0,0,1,0,31,15,16,5,0.05,0.05,0,0,0,0,70,1901
Marvelous Nakamba,26,Premier League,Midfielder,Aston Villa,1835,867,968,29,16,13,0,0,0,0,0,35,13,22,5,0,0,0,0,0,0,63,0
Mason Greenwood,19,Premier League,Midfielder,Manchester United,1310,747,563,31,16,15,10,7,3,1,0,10,7,3,0,0.76,0.07,0.69,0.84,0.48,131,42,1310
Mason Holgate,24,Premier League,Defender,Everton,2053,937,1116,27,14,13,0,0,0,3,0,28,5,23,5,0.13,0.13,0,0,0,0,76,684
Mason Mount,21,Premier League,Midfielder,Chelsea,2874,1415,1459,37,18,19,7,4,3,5,0,44,14,30,3,0.38,0.16,0.22,0.25,0.19,411,78,575
Matěj Vydra,28,Premier League,Forward,Burnley,812,341,471,19,7,12,2,1,1,1,0,7,1,6,0,0.33,0.11,0.22,0.26,0.19,406,43,812
Mateo Kovačić,26,Premier League,Midfielder,Chelsea,2073,994,1079,31,15,16,1,0,1,3,0,37,10,27,8,0.17,0.13,0.04,0,0.08,2073,67,691
Mathew Ryan,28,Premier League,Goalkeeper,Brighton & Hove Albion,3420,1710,1710,38,19,19,0,0,0,0,0,51,25,26,0,0,0,0,0,0,0,90,0
Matias Ezequiel Schelotto,31,Premier League,Defender,Brighton & Hove Albion,362,186,176,8,5,3,0,0,0,0,0,7,4,3,2,0,0,0,0,0,0,45,0
Matt Doherty,28,Premier League,Defender,Wolverhampton Wanderers,2840,1531,1309,36,19,17,4,3,1,3,0,26,11,15,1,0.22,0.1,0.13,0.18,0.07,710,79,947
Matt Macey,26,Premier League,Goalkeeper,Arsenal,0,0,0,0,0,0,0,0,0,0,0,0,0,0,0,0,0,0,0,0,0,0,0
Matt Ritchie,31,Premier League,Midfielder,Newcastle United,1316,705,611,18,9,9,2,2,0,1,0,16,6,10,4,0.21,0.07,0.14,0.26,0,658,73,1316
Matt Targett,25,Premier League,Defender,Aston Villa,2295,1104,1191,28,14,14,1,1,0,2,0,37,14,23,4,0.12,0.08,0.04,0.08,0,2295,82,1148
Mattéo Guendouzi Olié,21,Premier League,Midfielder,Arsenal,1747,826,921,24,11,13,0,0,0,1,0,30,15,15,6,0.05,0.05,0,0,0,0,73,1747
Matthew Longstaff,20,Premier League,Midfielder,Newcastle United,573,189,384,9,4,5,2,1,1,0,0,9,1,8,1,0.31,0,0.31,0.48,0.23,287,64,0
Matthew Lowton,31,Premier League,Defender,Burnley,1530,630,900,17,7,10,0,0,0,1,0,30,7,23,2,0.06,0.06,0,0,0,0,90,1530
Matthew Smith,20,Premier League,Defender,Arsenal,0,0,0,0,0,0,0,0,0,0,0,0,0,0,0,0,0,0,0,0,0,0,0
Matty James,29,Premier League,Midfielder,Leicester City,5,5,0,1,1,0,0,0,0,0,0,0,0,0,0,0,0,0,0,0,0,5,0
Max Kilman,23,Premier League,Defender,Wolverhampton Wanderers,184,90,94,3,1,2,0,0,0,0,0,2,1,1,0,0,0,0,0,0,0,61,0
Max Meyer,25,Premier League,Midfielder,Crystal Palace,649,324,325,17,10,7,0,0,0,0,0,11,3,8,1,0,0,0,0,0,0,38,0
Max Thompson,18,Premier League,Midfielder,Burnley,2,0,2,1,0,1,0,0,0,0,0,0,0,0,0,0,0,0,0,0,0,2,0
Maximillian James Aarons,20,Premier League,Midfielder,Norwich City,3240,1620,1620,36,18,18,0,0,0,1,0,68,34,34,7,0.03,0.03,0,0,0,0,90,3240
Maya Yoshida,32,Premier League,Defender,Southampton,558,288,270,8,5,3,0,0,0,0,0,17,14,3,1,0,0,0,0,0,0,70,0
Mbwana Ally Samatta,27,Premier League,Forward,Aston Villa,946,438,508,14,7,7,1,0,1,0,0,17,8,9,1,0.1,0,0.1,0,0.18,946,68,0
Mesut Özil,32,Premier League,Midfielder,Arsenal,1449,846,603,18,10,8,1,1,0,2,0,20,11,9,1,0.19,0.12,0.06,0.11,0,1449,81,725
Michael Keane,27,Premier League,Defender,Everton,2556,1278,1278,31,15,16,2,0,2,0,0,38,16,22,3,0.07,0,0.07,0,0.14,1278,82,0
Michael McGovern,36,Premier League,Goalkeeper,Norwich City,158,90,68,2,1,1,0,0,0,0,0,5,5,0,0,0,0,0,0,0,0,79,0
Michael Obafemi,20,Premier League,Forward,Southampton,660,219,441,21,10,11,3,0,3,2,0,11,4,7,1,0.68,0.27,0.41,0,0.61,220,31,330
Michael Verrips,23,Premier League,Goalkeeper,Sheffield United,0,0,0,0,0,0,0,0,0,0,0,0,0,0,0,0,0,0,0,0,0,0,0
Michail Antonio,30,Premier League,Midfielder,West Ham United,1770,785,985,24,11,13,10,4,6,3,1,29,14,15,3,0.66,0.15,0.51,0.46,0.55,177,74,590
Michel Vorm,37,Premier League,Goalkeeper,Tottenham Hotspur,0,0,0,0,0,0,0,0,0,0,0,0,0,0,0,0,0,0,0,0,0,0,0
Michy Batshuayi,27,Premier League,Forward,Chelsea,226,142,84,16,8,8,1,0,1,1,0,7,5,2,0,0.8,0.4,0.4,0,1.07,226,14,226
Miguel Ángel Almirón Rejala,26,Premier League,Midfielder,Newcastle United,3034,1659,1375,36,19,17,4,2,2,2,0,43,19,24,5,0.18,0.06,0.12,0.11,0.13,759,84,1517
Mihai Alexandru Dobre,22,Premier League,Midfielder,AFC Bournemouth,0,0,0,0,0,0,0,0,0,0,0,0,0,0,0,0,0,0,0,0,0,0,0
Mohamed Salah,28,Premier League,Forward,Liverpool,2888,1580,1308,34,18,16,19,15,4,10,3,26,13,13,1,0.9,0.31,0.59,0.85,0.28,152,85,289
Moise Kean,20,Premier League,Forward,Everton,834,414,420,29,13,16,2,2,0,2,0,12,7,5,1,0.43,0.22,0.22,0.43,0,417,29,417
Morgan Gibbs-White,20,Premier League,Midfielder,Wolverhampton Wanderers,124,124,0,7,6,1,0,0,0,0,0,1,1,0,0,0,0,0,0,0,0,18,0
Morgan Schneiderlin,31,Premier League,Midfielder,Everton,1004,462,542,15,6,9,0,0,0,0,0,15,6,9,6,0,0,0,0,0,0,67,0
Moritz Leitner,27,Premier League,Midfielder,Norwich City,686,307,379,9,4,5,0,0,0,0,0,14,10,4,1,0,0,0,0,0,0,76,0
Moussa Djenepo,22,Premier League,Midfielder,Southampton,926,628,298,18,11,7,2,0,2,2,0,12,7,5,5,0.39,0.19,0.19,0,0.6,463,51,463
Moussa Sissoko,31,Premier League,Midfielder,Tottenham Hotspur,2455,1350,1105,29,15,14,2,2,0,1,0,28,11,17,8,0.11,0.04,0.07,0.13,0,1228,85,2455
Muhamed Bešić,28,Premier League,Midfielder,Sheffield United,245,102,143,9,3,6,0,0,0,0,0,2,1,1,2,0,0,0,0,0,0,27,0
N'Golo Kanté,29,Premier League,Midfielder,Chelsea,1733,816,917,22,11,11,3,1,2,0,0,24,9,15,4,0.16,0,0.16,0.11,0.2,578,79,0
Nabil Bentaleb,25,Premier League,Midfielder,Newcastle United,749,287,462,12,6,6,0,0,0,0,0,12,4,8,2,0,0,0,0,0,0,62,0
Naby Deco Keïta,25,Premier League,Midfielder,Liverpool,814,275,539,18,7,11,2,1,1,3,0,7,4,3,1,0.55,0.33,0.22,0.33,0.17,407,45,271
Nacho Monreal,34,Premier League,Defender,Arsenal,270,90,180,3,1,2,0,0,0,0,0,4,1,3,0,0,0,0,0,0,0,90,0
Nampalys Mendy,28,Premier League,Midfielder,Leicester City,291,110,181,7,3,4,0,0,0,0,0,3,0,3,0,0,0,0,0,0,0,42,0
Nathan Aké,25,Premier League,Defender,AFC Bournemouth,2505,1335,1170,29,16,13,2,1,1,2,0,45,22,23,2,0.14,0.07,0.07,0.07,0.08,1253,86,1253
Nathan Holland,22,Premier League,Midfielder,West Ham United,31,12,19,2,1,1,0,0,0,0,0,1,0,1,0,0,0,0,0,0,0,16,0
Nathan Redmond,26,Premier League,Midfielder,Southampton,2771,1241,1530,32,15,17,4,0,4,4,0,48,28,20,2,0.26,0.13,0.13,0,0.24,693,87,693
Nathan Tella,21,Premier League,Midfielder,Southampton,2,0,2,1,0,1,0,0,0,0,0,0,0,0,0,0,0,0,0,0,0,2,0
Nathaniel Chalobah,25,Premier League,Midfielder,Watford,925,422,503,22,12,10,0,0,0,1,0,12,5,7,1,0.1,0.1,0,0,0,0,42,925
Nathaniel Phillips,23,Premier League,Defender,Liverpool,0,0,0,0,0,0,0,0,0,0,0,0,0,0,0,0,0,0,0,0,0,0,0
Neal Maupay,24,Premier League,Forward,Brighton & Hove Albion,2769,1442,1327,37,19,18,10,5,5,3,1,36,17,19,3,0.42,0.1,0.33,0.31,0.34,277,75,923
Neco Williams,19,Premier League,Midfielder,Liverpool,230,85,145,6,3,3,0,0,0,0,0,2,0,2,1,0,0,0,0,0,0,38,0
Neil Taylor,31,Premier League,Defender,Aston Villa,1089,594,495,14,8,6,0,0,0,0,0,24,14,10,2,0,0,0,0,0,0,78,0
Nemanja Matić,32,Premier League,Midfielder,Manchester United,1583,764,819,21,9,12,0,0,0,2,0,11,6,5,3,0.11,0.11,0,0,0,0,75,792
Nick Pope,28,Premier League,Goalkeeper,Burnley,3420,1710,1710,38,19,19,0,0,0,0,0,48,22,26,1,0,0,0,0,0,0,90,0
Nicolas Otamendi,32,Premier League,Defender,Manchester City,1710,825,885,24,12,12,2,2,0,0,0,18,5,13,3,0.11,0,0.11,0.22,0,855,71,0
Nicolas Pépé,25,Premier League,Forward,Arsenal,2012,1130,882,31,17,14,5,3,2,5,1,30,18,12,4,0.45,0.22,0.22,0.24,0.2,402,65,402
Nikola Tavares,21,Premier League,Defender,Crystal Palace,0,0,0,0,0,0,0,0,0,0,0,0,0,0,0,0,0,0,0,0,0,0,0
Nya Kirby,20,Premier League,Midfielder,Crystal Palace,0,0,0,0,0,0,0,0,0,0,0,0,0,0,0,0,0,0,0,0,0,0,0
Odion Jude Ighalo,31,Premier League,Forward,Manchester United,90,37,53,11,5,6,0,0,0,0,0,0,0,0,0,0,0,0,0,0,0,8,0
Oleksandr Zinchenko,23,Premier League,Midfielder,Manchester City,1272,507,765,19,7,12,0,0,0,0,0,12,4,8,2,0,0,0,0,0,0,67,0
Oliver McBurnie,24,Premier League,Forward,Sheffield United,2118,1155,963,36,19,17,6,5,1,0,0,24,12,12,4,0.25,0,0.25,0.39,0.09,353,59,0
Oliver Norwood,29,Premier League,Midfielder,Sheffield United,3101,1649,1452,38,19,19,1,1,0,1,1,35,14,21,8,0.06,0.03,0.03,0.05,0,3101,82,3101
Oliver Skipp,20,Premier League,Midfielder,Tottenham Hotspur,73,16,57,7,4,3,0,0,0,0,0,1,0,1,0,0,0,0,0,0,0,10,0
Olivier Giroud,34,Premier League,Forward,Chelsea,999,613,386,18,9,9,8,5,3,0,0,16,2,14,1,0.72,0,0.72,0.73,0.7,125,56,0
Ondrej Duda,25,Premier League,Midfielder,Norwich City,729,403,326,10,6,4,0,0,0,0,0,9,3,6,0,0,0,0,0,0,0,73,0
Onel Lázaro Hernández Mayea,27,Premier League,Midfielder,Norwich City,1379,731,648,26,12,14,1,1,0,2,0,32,18,14,0,0.2,0.13,0.07,0.12,0,1379,53,690
Onyinye Wilfred Ndidi,23,Premier League,Midfielder,Leicester City,2674,1399,1275,32,16,16,2,1,1,1,0,29,11,18,6,0.1,0.03,0.07,0.06,0.07,1337,84,2674
Oriol Romeu,29,Premier League,Midfielder,Southampton,1856,812,1044,30,14,16,0,0,0,0,0,35,20,15,5,0,0,0,0,0,0,62,0
Oskar Buur,22,Premier League,Defender,Wolverhampton Wanderers,0,0,0,0,0,0,0,0,0,0,0,0,0,0,0,0,0,0,0,0,0,0,0
Oumar Niasse,30,Premier League,Forward,Everton,19,2,17,3,1,2,0,0,0,0,0,0,0,0,0,0,0,0,0,0,0,6,0
Owen Otasowie,0,Premier League,Midfielder,Wolverhampton Wanderers,0,0,0,0,0,0,0,0,0,0,0,0,0,0,0,0,0,0,0,0,0,0,0
Pablo Fornals Malla,24,Premier League,Midfielder,West Ham United,2177,1046,1131,36,18,18,2,1,1,5,0,34,16,18,3,0.29,0.21,0.08,0.09,0.08,1089,60,435
Pablo Marí Villar,27,Premier League,Defender,Arsenal,114,90,24,2,1,1,0,0,0,0,0,0,0,0,0,0,0,0,0,0,0,57,0
Pablo Zabaleta,35,Premier League,Defender,West Ham United,589,268,321,10,5,5,0,0,0,0,0,13,6,7,2,0,0,0,0,0,0,59,0
Panagiotis Retsos,22,Premier League,Defender,Sheffield United,0,0,0,0,0,0,0,0,0,0,0,0,0,0,0,0,0,0,0,0,0,0,0
Pascal Groß,29,Premier League,Midfielder,Brighton & Hove Albion,1804,846,958,29,14,15,2,1,1,4,0,29,13,16,4,0.3,0.2,0.1,0.11,0.09,902,62,451
Patrick Cutrone,22,Premier League,Forward,Wolverhampton Wanderers,291,122,169,12,6,6,2,2,0,0,0,4,2,2,0,0.62,0,0.62,1.48,0,146,24,0
Patrick Roberts,23,Premier League,Midfielder,Norwich City,23,14,9,3,1,2,0,0,0,0,0,1,1,0,0,0,0,0,0,0,0,8,0
Patrick van Aanholt,30,Premier League,Defender,Crystal Palace,2511,1258,1253,29,15,14,3,1,2,2,1,37,14,23,0,0.18,0.07,0.11,0.07,0.14,837,87,1256
Paul Dummett,29,Premier League,Defender,Newcastle United,1229,610,619,16,7,9,0,0,0,0,0,18,5,13,2,0,0,0,0,0,0,77,0
Paul Pogba,27,Premier League,Midfielder,Manchester United,1204,637,567,16,8,8,1,0,1,3,0,8,6,2,1,0.3,0.22,0.07,0,0.16,1204,75,401
Paulo Dino Gazzaniga,28,Premier League,Goalkeeper,Tottenham Hotspur,1612,720,892,18,8,10,0,0,0,0,0,23,10,13,1,0,0,0,0,0,0,90,0
Pedro Lomba Neto,20,Premier League,Forward,Wolverhampton Wanderers,928,484,444,29,14,15,3,0,3,3,0,10,3,7,3,0.58,0.29,0.29,0,0.61,309,32,309
Pedro Rodriguez,33,Premier League,Midfielder,Chelsea,661,407,254,11,8,3,1,1,0,1,0,12,4,8,1,0.27,0.14,0.14,0.22,0,661,60,661
Pepe Reina,38,Premier League,Goalkeeper,Aston Villa,1080,450,630,12,5,7,0,0,0,0,0,18,6,12,1,0,0,0,0,0,0,90,0
Phil Bardsley,35,Premier League,Defender,Burnley,1890,1080,810,21,12,9,0,0,0,1,0,18,15,3,6,0.05,0.05,0,0,0,0,90,1890
Phil Jagielka,38,Premier League,Defender,Sheffield United,240,124,116,6,4,2,0,0,0,0,0,6,3,3,0,0,0,0,0,0,0,40,0
Phil Jones,28,Premier League,Defender,Manchester United,136,90,46,2,1,1,0,0,0,0,0,3,2,1,0,0,0,0,0,0,0,68,0
Philip Billing,24,Premier League,Midfielder,AFC Bournemouth,2535,1227,1308,34,17,17,1,1,0,1,0,40,20,20,8,0.07,0.04,0.04,0.07,0,2535,75,2535
Philip Foden,20,Premier League,Midfielder,Manchester City,892,532,360,23,13,10,5,4,1,2,0,5,2,3,0,0.71,0.2,0.5,0.68,0.25,178,39,446
Philip Heise,29,Premier League,Defender,Norwich City,0,0,0,0,0,0,0,0,0,0,0,0,0,0,0,0,0,0,0,0,0,0,0
Pierre-Emerick Aubameyang,31,Premier League,Forward,Arsenal,3139,1554,1585,36,18,18,22,13,9,3,2,42,22,20,4,0.72,0.09,0.63,0.75,0.51,143,87,1046
Pierre-Emile Højbjerg,25,Premier League,Midfielder,Southampton,2751,1440,1311,33,16,17,0,0,0,1,0,47,30,17,5,0.03,0.03,0,0,0,0,83,2751
Raheem Sterling,25,Premier League,Forward,Manchester City,2659,1214,1445,33,16,17,20,6,14,1,0,29,10,19,5,0.71,0.03,0.68,0.44,0.87,133,81,2659
Ralf Fährmann,32,Premier League,Goalkeeper,Norwich City,22,0,22,1,0,1,0,0,0,0,0,1,0,1,0,0,0,0,0,0,0,22,0
Raúl Alonso Jiménez Rodríguez,29,Premier League,Forward,Wolverhampton Wanderers,3252,1644,1608,38,19,19,17,8,9,6,4,34,16,18,3,0.64,0.17,0.47,0.44,0.5,191,86,542
Ravel Morrison,27,Premier League,Midfielder,Sheffield United,12,12,0,1,1,0,0,0,0,0,0,0,0,0,0,0,0,0,0,0,0,12,0
Reece James,20,Premier League,Defender,Chelsea,1510,760,750,24,11,13,0,0,0,2,0,23,5,18,1,0.12,0.12,0,0,0,0,63,755
Reiss Nelson,20,Premier League,Forward,Arsenal,627,315,312,17,7,10,1,1,0,0,0,5,3,2,1,0.14,0,0.14,0.29,0,627,37,0
Rhian Brewster,20,Premier League,Forward,Liverpool,0,0,0,0,0,0,0,0,0,0,0,0,0,0,0,0,0,0,0,0,0,0,0
Rhu-endly Martina,31,Premier League,Defender,Everton,0,0,0,0,0,0,0,0,0,0,0,0,0,0,0,0,0,0,0,0,0,0,0
Ricardo Domingos Barbosa Pereira,27,Premier League,Defender,Leicester City,2520,1350,1170,28,15,13,3,3,0,2,0,26,15,11,1,0.18,0.07,0.11,0.2,0,840,90,1260
Richairo Zivkovic,24,Premier League,Forward,Sheffield United,107,26,81,5,2,3,0,0,0,0,0,4,0,4,0,0,0,0,0,0,0,21,0
Richard Stearman,33,Premier League,Defender,Sheffield United,0,0,0,0,0,0,0,0,0,0,0,0,0,0,0,0,0,0,0,0,0,0,0
Richarlison de Andrade,23,Premier League,Forward,Everton,3081,1521,1560,36,18,18,13,7,6,3,0,47,18,29,8,0.47,0.09,0.38,0.41,0.35,237,86,1027
Riyad Mahrez,29,Premier League,Midfielder,Manchester City,1941,942,999,33,16,17,11,7,4,9,1,12,4,8,0,0.93,0.42,0.51,0.67,0.36,176,59,216
Rob Elliot,34,Premier League,Goalkeeper,Newcastle United,0,0,0,0,0,0,0,0,0,0,0,0,0,0,0,0,0,0,0,0,0,0,0
Rob Holding,25,Premier League,Defender,Arsenal,580,224,356,8,3,5,0,0,0,0,0,8,3,5,1,0,0,0,0,0,0,73,0
Robbie Brady,28,Premier League,Midfielder,Burnley,448,168,280,17,10,7,1,1,0,2,0,9,4,5,1,0.6,0.4,0.2,0.54,0,448,26,224
Robert Kenedy Nunes do Nascimento,24,Premier League,Midfielder,Chelsea,0,0,0,0,0,0,0,0,0,0,0,0,0,0,0,0,0,0,0,0,0,0,0
Robert Snodgrass,33,Premier League,Midfielder,West Ham United,1512,786,726,24,13,11,5,4,1,5,0,31,18,13,4,0.6,0.3,0.3,0.46,0.12,302,63,302
Roberto,34,Premier League,Goalkeeper,West Ham United,686,360,326,8,4,4,0,0,0,0,0,15,9,6,0,0,0,0,0,0,0,86,0
Roberto Firmino,29,Premier League,Forward,Liverpool,3003,1462,1541,38,19,19,9,1,8,8,0,26,11,15,0,0.51,0.24,0.27,0.06,0.47,334,79,375
Roberto Maximiliano Pereyra,29,Premier League,Forward,Watford,1649,800,849,28,14,14,3,2,1,0,1,26,12,14,4,0.16,0,0.16,0.23,0.11,550,59,0
Rodri,24,Premier League,Midfielder,Manchester City,2488,1082,1406,35,17,18,3,1,2,2,0,24,8,16,8,0.18,0.07,0.11,0.08,0.13,829,71,1244
Romain Saïss,30,Premier League,Midfielder,Wolverhampton Wanderers,2706,1260,1446,33,14,19,2,0,2,1,0,29,12,17,12,0.1,0.03,0.07,0,0.12,1353,82,2706
Ross Barkley,26,Premier League,Midfielder,Chelsea,1104,640,464,21,11,10,1,1,0,4,0,13,3,10,0,0.41,0.33,0.08,0.14,0,1104,53,276
Rúben Diogo Da Silva Neves,23,Premier League,Midfielder,Wolverhampton Wanderers,3060,1539,1521,38,19,19,2,2,0,2,0,31,15,16,9,0.12,0.06,0.06,0.12,0,1530,81,1530
Rúben Gonçalo Silva Nascimento Vinagre,21,Premier League,Defender,Wolverhampton Wanderers,644,122,522,16,4,12,0,0,0,0,0,6,0,6,1,0,0,0,0,0,0,40,0
Ruben Loftus-Cheek,24,Premier League,Midfielder,Chelsea,205,86,119,7,3,4,0,0,0,1,0,3,0,3,0,0.44,0.44,0,0,0,0,29,205
Rui Pedro dos Santos Patrício,32,Premier League,Goalkeeper,Wolverhampton Wanderers,3420,1710,1710,38,19,19,0,0,0,0,0,35,16,19,0,0,0,0,0,0,0,90,0
Ryan Bennett,30,Premier League,Defender,Leicester City,935,338,597,16,8,8,0,0,0,0,0,16,2,14,2,0,0,0,0,0,0,58,0
Ryan Bertrand,31,Premier League,Defender,Southampton,2743,1303,1440,32,16,16,1,1,0,1,0,41,20,21,4,0.07,0.03,0.03,0.07,0,2743,86,2743
Ryan Fraser,26,Premier League,Midfielder,AFC Bournemouth,2062,1113,949,28,13,15,1,1,0,4,0,33,17,16,2,0.22,0.17,0.04,0.08,0,2062,74,516
Ryan Fredericks,28,Premier League,Midfielder,West Ham United,2237,1097,1140,27,14,13,0,0,0,3,0,37,22,15,7,0.12,0.12,0,0,0,0,83,746
Ryan Giles,20,Premier League,Midfielder,Wolverhampton Wanderers,0,0,0,0,0,0,0,0,0,0,0,0,0,0,0,0,0,0,0,0,0,0,0
Ryan Sessegnon,20,Premier League,Defender,Tottenham Hotspur,341,161,180,6,3,3,0,0,0,0,0,5,2,3,0,0,0,0,0,0,0,57,0
Sadio Mané,28,Premier League,Forward,Liverpool,2755,1505,1250,35,18,17,18,11,7,7,0,27,14,13,3,0.82,0.23,0.59,0.66,0.5,153,79,394
Sam Byram,27,Premier League,Defender,Norwich City,1293,573,720,17,9,8,0,0,0,0,0,22,10,12,4,0,0,0,0,0,0,76,0
Sam Surridge,22,Premier League,Forward,AFC Bournemouth,23,23,0,4,3,1,0,0,0,0,0,0,0,0,0,0,0,0,0,0,0,6,0
Sam Woods,22,Premier League,Defender,Crystal Palace,0,0,0,0,0,0,0,0,0,0,0,0,0,0,0,0,0,0,0,0,0,0,0
Sander Berge,22,Premier League,Midfielder,Sheffield United,948,475,473,14,7,7,1,1,0,1,0,10,3,7,0,0.19,0.09,0.09,0.19,0,948,68,948
Scott Carson,35,Premier League,Goalkeeper,Manchester City,0,0,0,0,0,0,0,0,0,0,0,0,0,0,0,0,0,0,0,0,0,0,0
Scott Dann,33,Premier League,Defender,Crystal Palace,1265,727,538,16,9,7,0,0,0,1,0,14,8,6,0,0.07,0.07,0,0,0,0,79,1265
Scott McTominay,23,Premier League,Midfielder,Manchester United,1772,800,972,27,13,14,4,3,1,1,0,19,7,12,2,0.25,0.05,0.2,0.34,0.09,443,66,1772
Sead Kolašinac,27,Premier League,Defender,Arsenal,1699,724,975,26,14,12,0,0,0,2,0,24,10,14,4,0.11,0.11,0,0,0,0,65,850
Séamus Coleman,32,Premier League,Defender,Everton,1839,1026,813,27,15,12,0,0,0,1,0,24,12,12,5,0.05,0.05,0,0,0,0,68,1839
Sean Longstaff,23,Premier League,Midfielder,Newcastle United,1372,502,870,23,11,12,1,0,1,1,0,23,6,17,3,0.13,0.07,0.07,0,0.1,1372,60,1372
Sebastian Prödl,33,Premier League,Defender,Watford,57,57,0,1,1,0,0,0,0,0,0,0,0,0,0,0,0,0,0,0,0,57,0
Sébastien Haller,26,Premier League,Forward,West Ham United,2262,1245,1017,32,17,15,7,4,3,1,0,39,22,17,1,0.32,0.04,0.28,0.29,0.27,323,71,2262
Serge Aurier,27,Premier League,Defender,Tottenham Hotspur,2706,1449,1257,33,17,16,1,1,0,5,0,30,13,17,4,0.2,0.17,0.03,0.06,0,2706,82,541
Sergio Aguero,32,Premier League,Forward,Manchester City,1456,833,623,24,13,11,16,8,8,3,2,15,6,9,1,1.17,0.19,0.99,0.86,1.16,91,61,485
Sergio Germán Romero,33,Premier League,Goalkeeper,Manchester United,0,0,0,0,0,0,0,0,0,0,0,0,0,0,0,0,0,0,0,0,0,0,0
Shane Duffy,28,Premier League,Defender,Brighton & Hove Albion,1231,688,543,19,9,10,1,1,0,0,0,15,8,7,2,0.07,0,0.07,0.13,0,1231,65,0
Shane Long,33,Premier League,Forward,Southampton,1397,711,686,26,13,13,2,2,0,2,0,19,10,9,0,0.26,0.13,0.13,0.25,0,699,54,699
Shkodran Mustafi,28,Premier League,Defender,Arsenal,1206,473,733,15,6,9,0,0,0,1,0,15,6,9,2,0.07,0.07,0,0,0,0,80,1206
Simon Francis,35,Premier League,Defender,AFC Bournemouth,965,488,477,15,7,8,0,0,0,0,0,20,10,10,5,0,0,0,0,0,0,64,0
Simon Moore,30,Premier League,Goalkeeper,Sheffield United,180,90,90,2,1,1,0,0,0,0,0,6,3,3,0,0,0,0,0,0,0,90,0
Sofiane Boufal,27,Premier League,Midfielder,Southampton,758,451,307,20,9,11,0,0,0,2,0,14,8,6,2,0.24,0.24,0,0,0,0,38,379
Sokratis Papastathopoulos,32,Premier League,Defender,Arsenal,1697,990,707,19,11,8,2,2,0,0,0,25,15,10,6,0.11,0,0.11,0.18,0,849,89,0
Solomon March,26,Premier League,Midfielder,Brighton & Hove Albion,1143,566,577,19,9,10,0,0,0,1,0,14,6,8,2,0.08,0.08,0,0,0,0,60,1143
Stephen Henderson,32,Premier League,Goalkeeper,Crystal Palace,0,0,0,0,0,0,0,0,0,0,0,0,0,0,0,0,0,0,0,0,0,0,0
Steve Cook,29,Premier League,Defender,AFC Bournemouth,2430,1210,1220,29,14,15,1,1,0,0,0,45,21,24,7,0.04,0,0.04,0.07,0,2430,84,0
Steven Alzate,22,Premier League,Midfielder,Brighton & Hove Albion,1183,581,602,19,9,10,0,0,0,0,0,17,6,11,1,0,0,0,0,0,0,62,0
Steven Bergwijn,23,Premier League,Forward,Tottenham Hotspur,704,281,423,14,7,7,3,3,0,1,0,9,3,6,2,0.51,0.13,0.38,0.96,0,235,50,704
Stuart Armstrong,28,Premier League,Midfielder,Southampton,1716,744,972,30,15,15,5,1,4,3,0,23,11,12,4,0.42,0.16,0.26,0.12,0.37,343,57,572
Sung-Yeung Ki,31,Premier League,Midfielder,Newcastle United,136,17,119,3,1,2,0,0,0,0,0,5,0,5,0,0,0,0,0,0,0,45,0
Tahith Chong,20,Premier League,Forward,Manchester United,34,30,4,3,2,1,0,0,0,0,0,0,0,0,0,0,0,0,0,0,0,11,0
Takumi Minamino,25,Premier League,Forward,Liverpool,243,28,215,10,3,7,0,0,0,0,0,2,0,2,0,0,0,0,0,0,0,24,0
Tammy Abraham,23,Premier League,Forward,Chelsea,2221,956,1265,34,16,18,15,5,10,3,0,34,11,23,2,0.73,0.12,0.61,0.47,0.71,148,65,740
Tanguy Ndombele,23,Premier League,Midfielder,Tottenham Hotspur,1010,381,629,21,9,12,2,2,0,2,0,17,3,14,3,0.36,0.18,0.18,0.47,0,505,48,505
Tariq Lamptey,20,Premier League,Midfielder,Brighton & Hove Albion,622,253,369,9,4,5,0,0,0,1,0,8,6,2,2,0.14,0.14,0,0,0,0,69,622
Taylor Harwood-Bellis,18,Premier League,Defender,Manchester City,0,0,0,0,0,0,0,0,0,0,0,0,0,0,0,0,0,0,0,0,0,0,0
Taylor Perry,19,Premier League,Midfielder,Wolverhampton Wanderers,0,0,0,0,0,0,0,0,0,0,0,0,0,0,0,0,0,0,0,0,0,0,0
Teemu Pukki,30,Premier League,Forward,Norwich City,2894,1424,1470,36,18,18,11,7,4,3,2,57,30,27,3,0.44,0.09,0.34,0.44,0.24,263,80,965
Theo Walcott,31,Premier League,Forward,Everton,1295,696,599,25,14,11,2,1,1,3,0,18,8,10,1,0.35,0.21,0.14,0.13,0.15,648,52,432
Thomas David Allan,21,Premier League,Forward,Newcastle United,0,0,0,0,0,0,0,0,0,0,0,0,0,0,0,0,0,0,0,0,0,0,0
Thomas Doyle,19,Premier League,Midfielder,Manchester City,15,15,0,1,1,0,0,0,0,0,0,0,0,0,0,0,0,0,0,0,0,15,0
Tim Krul,32,Premier League,Goalkeeper,Norwich City,3240,1620,1620,36,18,18,0,0,0,0,0,66,31,35,4,0,0,0,0,0,0,90,0
Timm Klose,32,Premier League,Defender,Norwich City,586,406,180,7,5,2,0,0,0,0,0,13,10,3,0,0,0,0,0,0,0,84,0
Timothy Fosu-Mensah,22,Premier League,Defender,Manchester United,136,46,90,3,1,2,0,0,0,0,0,1,1,0,1,0,0,0,0,0,0,45,0
Toby Alderweireld,31,Premier League,Defender,Tottenham Hotspur,2958,1350,1608,33,15,18,2,1,1,2,0,36,11,25,7,0.12,0.06,0.06,0.07,0.06,1479,90,1479
Todd Cantwell,22,Premier League,Midfielder,Norwich City,2504,1127,1377,37,19,18,6,5,1,2,0,51,20,31,6,0.29,0.07,0.22,0.4,0.07,417,68,1252
Tom Cleverley,31,Premier League,Midfielder,Watford,967,415,552,18,8,10,1,1,0,0,0,24,9,15,2,0.09,0,0.09,0.22,0,967,54,0
Tom Davies,22,Premier League,Midfielder,Everton,2027,953,1074,30,16,14,1,0,1,0,0,29,8,21,8,0.04,0,0.04,0,0.08,2027,68,0
Tom Heaton,34,Premier League,Goalkeeper,Aston Villa,1795,900,895,20,10,10,0,0,0,0,0,33,13,20,0,0,0,0,0,0,0,90,0
Tom Trybull,27,Premier League,Midfielder,Norwich City,1138,511,627,16,7,9,0,0,0,0,0,25,12,13,2,0,0,0,0,0,0,71,0
Tomáš Souček,25,Premier League,Midfielder,West Ham United,1041,535,506,13,6,7,3,2,1,0,0,18,10,8,0,0.26,0,0.26,0.34,0.18,347,80,0
Trent Alexander-Arnold,22,Premier League,Defender,Liverpool,3176,1618,1558,38,19,19,4,2,2,13,0,31,15,16,5,0.48,0.37,0.11,0.11,0.12,794,84,244
Troy Deeney,32,Premier League,Forward,Watford,2234,1176,1058,27,14,13,10,6,4,2,5,36,17,19,3,0.48,0.08,0.4,0.46,0.34,223,83,1117
Troy Parrott,18,Premier League,Forward,Tottenham Hotspur,5,5,0,2,2,0,0,0,0,0,0,0,0,0,0,0,0,0,0,0,0,3,0
Tudor Cristian Băluţă,21,Premier League,Defender,Brighton & Hove Albion,0,0,0,0,0,0,0,0,0,0,0,0,0,0,0,0,0,0,0,0,0,0,0
Tyreece John-Jules,19,Premier League,Forward,Arsenal,0,0,0,0,0,0,0,0,0,0,0,0,0,0,0,0,0,0,0,0,0,0,0
Tyrick Mitchell,21,Premier League,Defender,Crystal Palace,193,96,97,4,2,2,0,0,0,0,0,3,1,2,1,0,0,0,0,0,0,48,0
Tyrone Mings,27,Premier League,Defender,Aston Villa,2903,1373,1530,33,16,17,2,1,1,2,0,50,20,30,7,0.12,0.06,0.06,0.07,0.06,1452,88,1452
Valentino Lazaro,24,Premier League,Midfielder,Newcastle United,474,191,283,13,6,7,1,0,1,0,0,11,4,7,1,0.19,0,0.19,0,0.32,474,36,0
Vicente Guaita,33,Premier League,Goalkeeper,Crystal Palace,3150,1620,1530,35,18,17,0,0,0,0,0,40,17,23,1,0,0,0,0,0,0,90,0
Víctor Camarasa,26,Premier League,Midfielder,Crystal Palace,5,0,5,1,0,1,0,0,0,0,0,0,0,0,0,0,0,0,0,0,0,5,0
Victor Nilsson Lindelöf,26,Premier League,Defender,Manchester United,3094,1576,1518,35,18,17,1,1,0,0,0,28,12,16,6,0.03,0,0.03,0.06,0,3094,88,0
Victor Wanyama,29,Premier League,Midfielder,Tottenham Hotspur,23,0,23,2,1,1,0,0,0,0,0,2,0,2,1,0,0,0,0,0,0,12,0
Virgil van Dijk,29,Premier League,Defender,Liverpool,3420,1710,1710,38,19,19,5,4,1,1,0,33,16,17,1,0.16,0.03,0.13,0.21,0.05,684,90,3420
Wayne Hennessey,33,Premier League,Goalkeeper,Crystal Palace,270,90,180,3,1,2,0,0,0,0,0,8,2,6,0,0,0,0,0,0,0,90,0
Wes Morgan,36,Premier League,Defender,Leicester City,429,198,231,11,4,7,0,0,0,0,0,5,1,4,0,0,0,0,0,0,0,39,0
Wesley Moraes Ferreira da Silva,23,Premier League,Forward,Aston Villa,1790,880,910,21,10,11,5,1,4,1,0,31,12,19,3,0.3,0.05,0.25,0.1,0.4,358,85,1790
Wilfredo Daniel Caballero,39,Premier League,Goalkeeper,Chelsea,450,270,180,5,3,2,0,0,0,0,0,7,3,4,0,0,0,0,0,0,0,90,0
Wilfried Zaha,28,Premier League,Midfielder,Crystal Palace,3280,1645,1635,38,19,19,4,3,1,3,0,44,19,25,5,0.19,0.08,0.11,0.16,0.06,820,86,1093
Will Ferry,18,Premier League,Midfielder,Southampton,0,0,0,0,0,0,0,0,0,0,0,0,0,0,0,0,0,0,0,0,0,0,0
Will Hughes,25,Premier League,Midfielder,Watford,2263,1025,1238,30,14,16,1,0,1,1,0,43,17,26,9,0.08,0.04,0.04,0,0.07,2263,75,2263
William Smallbone,20,Premier League,Midfielder,Southampton,392,218,174,9,4,5,0,0,0,2,0,4,1,3,0,0.46,0.46,0,0,0,0,44,196
Willian,32,Premier League,Forward,Chelsea,2604,1274,1330,36,18,18,9,4,5,7,4,34,11,23,4,0.55,0.24,0.31,0.28,0.34,289,72,372
Willy Boly,29,Premier League,Defender,Wolverhampton Wanderers,1980,990,990,22,11,11,0,0,0,1,0,13,5,8,3,0.05,0.05,0,0,0,0,90,1980
Winston Reid,32,Premier League,Defender,West Ham United,0,0,0,0,0,0,0,0,0,0,0,0,0,0,0,0,0,0,0,0,0,0,0
Xherdan Shaqiri,29,Premier League,Midfielder,Liverpool,181,166,15,7,3,4,1,1,0,0,0,2,2,0,0,0.5,0,0.5,0.54,0,181,26,0
Yann Valery,21,Premier League,Defender,Southampton,784,400,384,11,6,5,0,0,0,0,0,20,15,5,1,0,0,0,0,0,0,71,0
Yerry Fernando Mina González,26,Premier League,Defender,Everton,2282,1107,1175,29,14,15,2,0,2,1,0,31,11,20,3,0.12,0.04,0.08,0,0.15,1141,79,2282
Yoshinori Muto,28,Premier League,Forward,Newcastle United,207,98,109,8,2,6,0,0,0,0,0,6,3,3,0,0,0,0,0,0,0,26,0
Youri Tielemans,23,Premier League,Midfielder,Leicester City,2834,1433,1401,37,19,18,3,2,1,6,0,34,15,19,2,0.29,0.19,0.1,0.13,0.06,945,77,472
Yves Bissouma,24,Premier League,Midfielder,Brighton & Hove Albion,1263,636,627,22,11,11,1,0,1,0,0,18,13,5,4,0.07,0,0.07,0,0.14,1263,57,0
Zechariah Medley,20,Premier League,Defender,Arsenal,0,0,0,0,0,0,0,0,0,0,0,0,0,0,0,0,0,0,0,0,0,0,0
Ørjan Håskjold Nyland,30,Premier League,Goalkeeper,Aston Villa,537,360,177,7,4,3,0,0,0,0,0,12,9,3,0,0,0,0,0,0,0,77,0
Łukasz Fabiański,35,Premier League,Goalkeeper,West Ham United,2119,1170,949,25,13,12,0,0,0,0,0,33,19,14,1,0,0,0,0,0,0,85,0