full_name,age,league,position,current_club,minutes_played_overall,minutes_played_home,minutes_played_away,appearances_overall,appearances_home,appearances_away,goals_overall,goals_home,goals_away,assists_overall,penalty_goals,conceded_overall,conceded_home,conceded_away,yellow_cards_overall,goals_involved_per_90_overall,assists_per_90_overall,goals_per_90_overall,goals_per_90_home,goals_per_90_away,min_per_goal_overall,min_per_match,min_per_assist_overall
Aaron Ramsey,29,Serie A,Midfielder,Juventus,1049,587,462,24,12,12,3,2,1,1,0,12,3,9,2,0.34,0.09,0.26,0.31,0.19,350,44,1049
Abdoulaye Traorè,20,Serie A,Forward,Hellas Verona,0,0,0,0,0,0,0,0,0,0,0,0,0,0,0,0,0,0,0,0,0,0,0
Adam Marušić,28,Serie A,Defender,Lazio,940,500,440,15,9,6,2,1,1,1,0,10,4,6,3,0.29,0.1,0.19,0.18,0.2,470,63,940
Adrien Rabiot,25,Serie A,Midfielder,Juventus,1917,1110,807,28,15,13,1,0,1,1,0,20,8,12,7,0.09,0.05,0.05,0,0.11,1917,68,1917
Adrien Tameze,26,Serie A,Midfielder,Atalanta,206,91,115,7,2,5,0,0,0,0,0,2,2,0,0,0,0,0,0,0,0,29,0
Alan Pereira Empereur,26,Serie A,Defender,Hellas Verona,852,410,442,13,6,7,0,0,0,0,0,14,5,9,3,0,0,0,0,0,0,66,0
Alberto Cerri,24,Serie A,Forward,SPAL,655,279,376,19,9,10,2,2,0,0,0,22,12,10,2,0.27,0,0.27,0.65,0,328,34,0
Alberto Grassi,25,Serie A,Midfielder,Parma,636,351,285,16,9,7,1,1,0,1,0,12,4,8,6,0.28,0.14,0.14,0.26,0,636,40,636
Alberto Paloschi,30,Serie A,Forward,Cagliari,637,295,342,17,9,8,0,0,0,0,0,10,5,5,0,0,0,0,0,0,0,37,0
Albin Ekdal,31,Serie A,Midfielder,Sampdoria,2386,1206,1180,32,16,16,0,0,0,2,0,39,16,23,8,0.08,0.08,0,0,0,0,75,1193
Alejandro Gómez,32,Serie A,Midfielder,Atalanta,2860,1394,1466,36,18,18,7,3,4,16,0,35,19,16,2,0.72,0.5,0.22,0.19,0.25,409,79,179
Aleksa Terzić,21,Serie A,Defender,Fiorentina,6,6,0,2,1,1,0,0,0,0,0,0,0,0,0,0,0,0,0,0,0,3,0
Aleksandar Kolarov,34,Serie A,Defender,Roma,2730,1560,1170,32,19,13,7,2,5,3,2,35,24,11,6,0.33,0.1,0.23,0.12,0.38,390,85,910
Aleš Matějů,24,Serie A,Defender,Brescia,2548,1281,1267,31,15,16,0,0,0,1,0,53,22,31,10,0.04,0.04,0,0,0,0,82,2548
Alessandro Bastoni,21,Serie A,Defender,Inter Milan,1922,1033,889,25,13,12,2,0,2,0,0,23,12,11,9,0.09,0,0.09,0,0.2,961,77,0
Alessandro Berardi,29,Serie A,Goalkeeper,Hellas Verona,0,0,0,0,0,0,0,0,0,0,0,0,0,0,0,0,0,0,0,0,0,0,0
Alessandro Buongiorno,21,Serie A,Defender,Torino,0,0,0,0,0,0,0,0,0,0,0,0,0,0,0,0,0,0,0,0,0,0,0
Alessandro Deiola,25,Serie A,Midfielder,Lecce,718,345,373,11,6,5,1,1,0,1,0,18,8,10,3,0.25,0.13,0.13,0.26,0,718,65,718
Alessandro Florenzi,29,Serie A,Midfielder,Roma,1002,588,414,14,7,7,0,0,0,1,0,14,11,3,5,0.09,0.09,0,0,0,0,72,1002
Alessandro Lombardi,20,Serie A,Midfielder,Cagliari,0,0,0,0,0,0,0,0,0,0,0,0,0,0,0,0,0,0,0,0,0,0,0
Alessandro Matri,36,Serie A,Forward,Brescia,82,48,34,8,4,4,0,0,0,0,0,1,0,1,2,0,0,0,0,0,0,10,0
Alessandro Mercati,18,Serie A,Midfielder,Sassuolo,0,0,0,0,0,0,0,0,0,0,0,0,0,0,0,0,0,0,0,0,0,0,0
Alessandro Murgia,24,Serie A,Midfielder,SPAL,1752,916,836,25,13,12,0,0,0,1,0,39,22,17,3,0.05,0.05,0,0,0,0,70,1752
Alessandro Russo,19,Serie A,Goalkeeper,Sassuolo,0,0,0,0,0,0,0,0,0,0,0,0,0,0,0,0,0,0,0,0,0,0,0
Alessandro Semprini,22,Serie A,Defender,Brescia,627,311,316,12,7,5,1,1,0,0,0,19,4,15,2,0.14,0,0.14,0.29,0,627,52,0
Alessandro Tripaldelli,21,Serie A,Defender,Sassuolo,134,134,0,2,2,0,0,0,0,0,0,4,4,0,0,0,0,0,0,0,0,67,0
Alessio Cragno,26,Serie A,Goalkeeper,Cagliari,1440,720,720,16,8,8,0,0,0,0,0,20,7,13,1,0,0,0,0,0,0,90,0
Alessio Riccardi,19,Serie A,Forward,Roma,0,0,0,0,0,0,0,0,0,0,0,0,0,0,0,0,0,0,0,0,0,0,0
Alessio Romagnoli,25,Serie A,Defender,AC Milan,3092,1530,1562,35,17,18,1,1,0,0,0,41,18,23,4,0.03,0,0.03,0.06,0,3092,88,0
Álex Berenguer,25,Serie A,Forward,Torino,1828,753,1075,29,14,15,6,2,4,2,0,36,15,21,4,0.39,0.1,0.3,0.24,0.33,305,63,914
Alex Ferrari,26,Serie A,Defender,Sampdoria,1005,519,486,12,6,6,0,0,0,0,0,12,5,7,4,0,0,0,0,0,0,84,0
Alex Meret,23,Serie A,Goalkeeper,Napoli,1950,810,1140,22,9,13,0,0,0,0,0,30,9,21,0,0,0,0,0,0,0,89,0
Alex Sandro,29,Serie A,Defender,Juventus,2386,1121,1265,29,14,15,1,0,1,3,0,29,10,19,4,0.15,0.11,0.04,0,0.07,2386,82,795
Alexis Saelemaekers,21,Serie A,Midfielder,AC Milan,684,265,419,13,6,7,1,1,0,0,0,9,4,5,4,0.13,0,0.13,0.34,0,684,53,0
Alexis Sanchez,31,Serie A,Forward,Inter Milan,917,490,427,22,11,11,4,1,3,8,1,9,5,4,4,1.18,0.79,0.39,0.18,0.63,229,42,115
Alfred Duncan,27,Serie A,Midfielder,Fiorentina,1735,907,828,26,13,13,2,1,1,6,0,25,15,10,5,0.41,0.31,0.1,0.1,0.11,868,67,289
Alfredo Donnarumma,29,Serie A,Forward,Brescia,1685,728,957,31,15,16,7,5,2,2,2,41,16,25,1,0.48,0.11,0.37,0.62,0.19,241,54,843
Allan,29,Serie A,Midfielder,Napoli,1281,520,761,23,10,13,2,1,1,1,0,19,7,12,3,0.21,0.07,0.14,0.17,0.12,641,56,1281
Altin Kryeziu,18,Serie A,Midfielder,SPAL,0,0,0,0,0,0,0,0,0,0,0,0,0,0,0,0,0,0,0,0,0,0,0
Aly Malle,22,Serie A,Forward,Udinese,0,0,0,0,0,0,0,0,0,0,0,0,0,0,0,0,0,0,0,0,0,0,0
Amad Diallo Traoré,18,Serie A,Forward,Atalanta,24,24,0,3,3,0,1,1,0,0,0,0,0,0,0,3.75,0,3.75,3.75,0,24,8,0
Amadou Diawara,23,Serie A,Midfielder,Roma,1523,808,715,22,11,11,1,0,1,1,1,19,12,7,4,0.12,0.06,0.06,0,0.13,1523,69,1523
Amin Younes,27,Serie A,Forward,Napoli,169,96,73,9,4,5,1,1,0,0,0,1,0,1,1,0.53,0,0.53,0.94,0,169,19,0
Amir Rrahmani,26,Serie A,Defender,Hellas Verona,3229,1609,1620,36,18,18,0,0,0,1,0,42,22,20,5,0.03,0.03,0,0,0,0,90,3229
André Anderson Pomilio Lima da Silva,21,Serie A,Forward,Lazio,56,10,46,6,1,5,0,0,0,0,0,1,0,1,0,0,0,0,0,0,0,9,0
André Silva,25,Serie A,Forward,AC Milan,61,61,0,1,1,0,0,0,0,0,0,0,0,0,1,0,0,0,0,0,0,61,0
Andrea Adorante,20,Serie A,Forward,Parma,0,0,0,0,0,0,0,0,0,0,0,0,0,0,0,0,0,0,0,0,0,0,0
Andrea Belotti,26,Serie A,Forward,Torino,3010,1466,1544,36,18,18,16,8,8,3,7,58,23,35,4,0.57,0.09,0.48,0.49,0.47,188,84,1003
Andrea Bertolacci,29,Serie A,Midfielder,Sampdoria,537,333,204,12,8,4,0,0,0,0,0,8,5,3,3,0,0,0,0,0,0,45,0
Andrea Carboni,19,Serie A,Defender,Cagliari,369,161,208,7,3,4,0,0,0,0,0,7,3,4,6,0,0,0,0,0,0,53,0
Andrea Cistana,23,Serie A,Midfielder,Brescia,1839,939,900,21,11,10,1,1,0,0,0,32,19,13,8,0.05,0,0.05,0.1,0,1839,88,0
Andrea Consigli,33,Serie A,Goalkeeper,Sassuolo,2790,1530,1260,31,17,14,0,0,0,0,0,50,28,22,1,0,0,0,0,0,0,90,0
Andrea Conti,26,Serie A,Defender,AC Milan,1729,758,971,23,9,14,0,0,0,2,0,27,11,16,8,0.1,0.1,0,0,0,0,75,865
Andrea Danzi,21,Serie A,Midfielder,Hellas Verona,0,0,0,1,0,1,0,0,0,0,0,0,0,0,0,0,0,0,0,0,0,0,0
Andrea Favilli,23,Serie A,Forward,Genoa,652,382,270,20,11,9,0,0,0,0,0,11,7,4,4,0,0,0,0,0,0,33,0
Andrea Ghezzi,19,Serie A,Midfielder,Brescia,32,21,11,5,3,2,0,0,0,0,0,2,0,2,0,0,0,0,0,0,0,6,0
Andrea Ghion,20,Serie A,Midfielder,Sassuolo,45,23,22,3,1,2,0,0,0,0,0,0,0,0,0,0,0,0,0,0,0,15,0
Andrea La Mantia,29,Serie A,Forward,Lecce,550,238,312,12,6,6,2,0,2,0,0,17,6,11,1,0.33,0,0.33,0,0.58,275,46,0
Andrea Masiello,34,Serie A,Defender,Genoa,1872,850,1022,22,10,12,0,0,0,1,0,34,16,18,5,0.05,0.05,0,0,0,0,85,1872
Andrea Papetti,18,Serie A,Defender,Brescia,917,384,533,11,5,6,1,1,0,0,0,25,7,18,5,0.1,0,0.1,0.23,0,917,83,0
Andrea Petagna,25,Serie A,Forward,SPAL,3033,1551,1482,36,18,18,12,6,6,1,5,55,28,27,5,0.39,0.03,0.36,0.35,0.36,253,84,3033
Andrea Pinamonti,21,Serie A,Forward,Genoa,2239,1121,1118,32,16,16,5,1,4,1,1,43,18,25,1,0.24,0.04,0.2,0.08,0.32,448,70,2239
Andrea Poli,31,Serie A,Midfielder,Bologna,1926,986,940,28,16,12,2,1,1,0,0,31,16,15,5,0.09,0,0.09,0.09,0.1,963,69,0
Andrea Ranocchia,32,Serie A,Defender,Inter Milan,525,255,270,7,4,3,0,0,0,0,0,2,1,1,3,0,0,0,0,0,0,75,0
Andrea Rispoli,32,Serie A,Defender,Lecce,1904,1021,883,28,14,14,0,0,0,0,0,42,23,19,6,0,0,0,0,0,0,68,0
Andrea Seculin,30,Serie A,Goalkeeper,Sampdoria,0,0,0,0,0,0,0,0,0,0,0,0,0,0,0,0,0,0,0,0,0,0,0
Andrea Tabanelli,30,Serie A,Midfielder,Lecce,965,425,540,13,7,6,1,1,0,0,0,16,9,7,4,0.09,0,0.09,0.21,0,965,74,0
Andreas Cornelius,27,Serie A,Forward,Parma,1491,729,762,26,12,14,12,6,6,3,0,19,9,10,1,0.91,0.18,0.72,0.74,0.71,124,57,497
Andreas Skov Olsen,20,Serie A,Midfielder,Bologna,747,423,324,26,12,14,1,0,1,0,0,10,6,4,2,0.12,0,0.12,0,0.28,747,29,0
Andreaw Gravillon,22,Serie A,Defender,Sassuolo,0,0,0,0,0,0,0,0,0,0,0,0,0,0,0,0,0,0,0,0,0,0,0
Andri Fannar Baldursson,18,Serie A,Midfielder,Bologna,136,77,59,7,4,3,0,0,0,0,0,2,0,2,0,0,0,0,0,0,0,19,0
Ante Rebić,27,Serie A,Forward,AC Milan,1396,728,668,26,13,13,11,6,5,3,0,20,10,10,5,0.9,0.19,0.71,0.74,0.67,127,54,465
Antonín Barák,25,Serie A,Midfielder,Lecce,1556,793,763,24,11,13,2,2,0,1,0,37,21,16,1,0.17,0.06,0.12,0.23,0,778,65,1556
Antonino Barillà,32,Serie A,Midfielder,Parma,1692,783,909,26,12,14,1,1,0,2,0,30,12,18,6,0.16,0.11,0.05,0.11,0,1692,65,846
Antonino Gallo,20,Serie A,Defender,Lecce,0,0,0,0,0,0,0,0,0,0,0,0,0,0,0,0,0,0,0,0,0,0,0
Antonino La Gumina,24,Serie A,Forward,Sampdoria,186,103,83,5,2,3,0,0,0,0,0,3,0,3,0,0,0,0,0,0,0,37,0
Antonio Barreca,25,Serie A,Defender,Genoa,1096,667,429,18,11,7,0,0,0,1,0,21,11,10,0,0.08,0.08,0,0,0,0,61,1096
Antonio Candreva,33,Serie A,Midfielder,Inter Milan,2000,1015,985,32,16,16,5,3,2,7,0,26,11,15,5,0.54,0.32,0.23,0.27,0.18,400,63,286
Antonio Donnarumma,30,Serie A,Goalkeeper,AC Milan,0,0,0,0,0,0,0,0,0,0,0,0,0,0,1,0,0,0,0,0,0,0,0
Antonio Mirante,37,Serie A,Goalkeeper,Roma,450,180,270,5,2,3,0,0,0,0,0,5,3,2,0,0,0,0,0,0,0,90,0
Antonio Pio Daniele,18,Serie A,Goalkeeper,Napoli,0,0,0,0,0,0,0,0,0,0,0,0,0,0,0,0,0,0,0,0,0,0,0
Antonio Rosati,37,Serie A,Goalkeeper,Torino,90,0,90,1,0,1,0,0,0,0,0,1,0,1,0,0,0,0,0,0,0,90,0
Antonio Sanabria,24,Serie A,Forward,Genoa,1390,670,720,24,11,13,6,3,3,2,0,32,14,18,3,0.52,0.13,0.39,0.4,0.38,232,58,695
Arkadiusz Milik,26,Serie A,Forward,Napoli,1751,934,817,26,14,12,11,7,4,0,0,22,12,10,5,0.57,0,0.57,0.67,0.44,159,67,0
Arkadiusz Reca,25,Serie A,Midfielder,SPAL,1932,965,967,25,13,12,0,0,0,2,0,41,21,20,2,0.09,0.09,0,0,0,0,77,966
Armando Izzo,28,Serie A,Defender,Torino,2688,1262,1426,31,15,16,1,0,1,0,0,49,19,30,8,0.03,0,0.03,0,0.06,2688,87,0
Artur Ioniţă,30,Serie A,Midfielder,Cagliari,1894,987,907,34,17,17,0,0,0,2,0,28,13,15,6,0.1,0.1,0,0,0,0,56,947
Ashley Young,35,Serie A,Midfielder,Inter Milan,1186,615,571,18,9,9,4,2,2,4,0,17,9,8,1,0.61,0.3,0.3,0.29,0.32,297,66,297
Asmir Begović,33,Serie A,Goalkeeper,AC Milan,128,90,38,2,1,1,0,0,0,0,0,3,2,1,0,0,0,0,0,0,0,64,0
Augustas Dubickas,19,Serie A,Midfielder,Lecce,0,0,0,0,0,0,0,0,0,0,0,0,0,0,0,0,0,0,0,0,0,0,0
Bakary Adama Soumaoro,28,Serie A,Defender,Genoa,637,360,277,8,4,4,1,0,1,0,0,14,10,4,2,0.14,0,0.14,0,0.32,637,80,0
Bartosz Bereszyński,28,Serie A,Defender,Sampdoria,2405,1158,1247,28,14,14,0,0,0,0,0,47,20,27,10,0,0,0,0,0,0,86,0
Bartosz Salamon,29,Serie A,Defender,SPAL,341,131,210,7,4,3,0,0,0,0,0,7,3,4,1,0,0,0,0,0,0,49,0
Bartłomiej Drągowski,23,Serie A,Goalkeeper,Fiorentina,2790,1530,1260,31,17,14,0,0,0,0,0,39,22,17,1,0,0,0,0,0,0,90,0
Bastos,29,Serie A,Defender,Lazio,756,338,418,16,7,9,1,1,0,0,0,10,5,5,4,0.12,0,0.12,0.27,0,756,47,0
Berat Djimsiti,27,Serie A,Defender,Atalanta,2789,1555,1234,34,19,15,2,2,0,1,0,35,23,12,5,0.1,0.03,0.06,0.12,0,1395,82,2789
Biagio Meccariello,29,Serie A,Defender,Lecce,767,426,341,14,7,7,1,1,0,0,0,20,13,7,2,0.12,0,0.12,0.21,0,767,55,0
Birkir Bjarnason,32,Serie A,Midfielder,Brescia,802,354,448,13,6,7,0,0,0,1,0,24,6,18,1,0.11,0.11,0,0,0,0,62,802
Blaise Matuidi,33,Serie A,Midfielder,Juventus,2231,1252,979,35,19,16,0,0,0,2,0,23,12,11,2,0.08,0.08,0,0,0,0,64,1116
Blerim Džemaili,34,Serie A,Midfielder,Bologna,696,344,352,14,6,8,1,1,0,1,0,17,7,10,2,0.26,0.13,0.13,0.26,0,696,50,696
Bobby Adekanye,21,Serie A,Forward,Lazio,177,134,43,11,7,4,1,1,0,0,0,3,3,0,1,0.51,0,0.51,0.67,0,177,16,0
Bogdan Jocic,19,Serie A,Midfielder,Hellas Verona,0,0,0,0,0,0,0,0,0,0,0,0,0,0,0,0,0,0,0,0,0,0,0
Boris Radunović,24,Serie A,Goalkeeper,Hellas Verona,270,180,90,3,2,1,0,0,0,0,0,7,4,3,1,0,0,0,0,0,0,90,0
Borja Valero,35,Serie A,Midfielder,Inter Milan,925,655,270,19,11,8,2,1,1,0,0,8,6,2,4,0.19,0,0.19,0.14,0.33,463,49,0
Boško Šutalo,20,Serie A,Midfielder,Atalanta,278,105,173,7,4,3,0,0,0,0,0,3,2,1,1,0,0,0,0,0,0,40,0
Botond Balogh,18,Serie A,Defender,Parma,0,0,0,0,0,0,0,0,0,0,0,0,0,0,0,0,0,0,0,0,0,0,0
Brain Oddei,18,Serie A,Forward,Sassuolo,0,0,0,0,0,0,0,0,0,0,0,0,0,0,0,0,0,0,0,0,0,0,0
Bram Nuytinck,30,Serie A,Defender,Udinese,2229,1055,1174,26,12,14,0,0,0,0,0,27,11,16,2,0,0,0,0,0,0,86,0
Brayan Emanuel Vera Ramírez,21,Serie A,Forward,Lecce,149,43,106,8,4,4,0,0,0,1,0,2,0,2,0,0.6,0.6,0,0,0,0,19,149
Bruno Alves,38,Serie A,Defender,Parma,2673,1312,1361,33,16,17,0,0,0,0,0,43,19,24,4,0,0,0,0,0,0,81,0
Bruno da Silva Peres,30,Serie A,Defender,Roma,1058,556,502,16,8,8,2,0,2,2,0,15,7,8,3,0.34,0.17,0.17,0,0.36,529,66,529
Bruno Martella,28,Serie A,Defender,Brescia,1263,505,758,24,11,13,0,0,0,0,0,28,8,20,3,0,0,0,0,0,0,53,0
Bryan Cristante,25,Serie A,Midfielder,Roma,1613,912,701,26,14,12,1,1,0,3,0,30,15,15,8,0.22,0.17,0.06,0.1,0,1613,62,538
Bryan Dabo,28,Serie A,Midfielder,SPAL,1123,652,471,16,9,7,1,0,1,4,0,33,17,16,4,0.4,0.32,0.08,0,0.19,1123,70,281
Carles Pérez Sayol,22,Serie A,Forward,Roma,562,246,316,14,7,7,1,0,1,3,0,11,4,7,2,0.64,0.48,0.16,0,0.28,562,40,187
Carlo Pinsoglio,30,Serie A,Goalkeeper,Juventus,18,18,0,1,1,0,0,0,0,0,0,0,0,0,0,0,0,0,0,0,0,18,0
Cengiz Ünder,23,Serie A,Midfielder,Roma,873,446,427,18,10,8,3,2,1,0,0,17,8,9,2,0.31,0,0.31,0.4,0.21,291,49,0
Charalampos Lykogiannis,27,Serie A,Defender,Cagliari,1337,501,836,20,7,13,0,0,0,1,0,16,5,11,4,0.07,0.07,0,0,0,0,67,1337
Chris Smalling,30,Serie A,Defender,Roma,2566,1186,1380,30,14,16,3,1,2,2,0,36,17,19,3,0.18,0.07,0.11,0.08,0.13,855,86,1283
Christian Celesia,18,Serie A,Defender,Torino,0,0,0,1,0,1,0,0,0,0,0,0,0,0,0,0,0,0,0,0,0,0,0
Christian Dalle Mura,18,Serie A,Defender,Fiorentina,0,0,0,1,0,1,0,0,0,0,0,0,0,0,0,0,0,0,0,0,0,0,0
Christian Dell'Orco,26,Serie A,Defender,Lecce,1007,452,555,14,7,7,0,0,0,1,0,20,9,11,2,0.09,0.09,0,0,0,0,72,1007
Christian Eriksen,28,Serie A,Midfielder,Inter Milan,700,352,348,17,8,9,1,1,0,2,0,5,3,2,0,0.39,0.26,0.13,0.26,0,700,41,350
Christian Gabriel Oliva Giménez,24,Serie A,Midfielder,Cagliari,463,187,276,11,6,5,1,0,1,1,0,6,5,1,1,0.39,0.19,0.19,0,0.33,463,42,463
Christian Kouamé,22,Serie A,Forward,Fiorentina,1215,661,554,18,10,8,6,2,4,3,0,24,7,17,1,0.67,0.22,0.44,0.27,0.65,203,68,405
Christian Pierobon,18,Serie A,Midfielder,Hellas Verona,0,0,0,0,0,0,0,0,0,0,0,0,0,0,0,0,0,0,0,0,0,0,0
Ciro Immobile,30,Serie A,Forward,Lazio,3176,1578,1598,37,18,19,36,19,17,9,14,34,13,21,8,1.28,0.26,1.02,1.08,0.96,88,86,353
Claud Adjapong,22,Serie A,Defender,Hellas Verona,228,24,204,5,1,4,0,0,0,0,0,4,0,4,0,0,0,0,0,0,0,46,0
Cristian Daniel Ansaldi,34,Serie A,Defender,Torino,1772,925,847,27,14,13,4,1,3,4,0,30,13,17,9,0.41,0.2,0.2,0.1,0.32,443,66,443
Cristian Gabriel Romero,22,Serie A,Defender,Genoa,2581,1301,1280,30,15,15,1,1,0,1,0,51,22,29,15,0.07,0.03,0.03,0.07,0,2581,86,2581
Cristián Zapata,34,Serie A,Defender,Genoa,1717,990,727,20,11,9,1,1,0,0,0,29,12,17,4,0.05,0,0.05,0.09,0,1717,86,0
Cristiano Biraghi,28,Serie A,Defender,Inter Milan,1578,793,785,26,14,12,2,1,1,6,0,13,6,7,3,0.46,0.34,0.11,0.11,0.11,789,61,263
Cristiano Ronaldo,35,Serie A,Forward,Juventus,2919,1495,1424,33,17,16,31,22,9,5,12,33,13,20,3,1.11,0.15,0.96,1.32,0.57,94,88,584
Cristóbal Montiel Rodríguez,20,Serie A,Midfielder,Fiorentina,0,0,0,0,0,0,0,0,0,0,0,0,0,0,0,0,0,0,0,0,0,0,0
Dalbert Henrique,27,Serie A,Defender,Fiorentina,2491,1303,1188,31,16,15,0,0,0,5,0,33,18,15,9,0.18,0.18,0,0,0,0,80,498
Daniel Cerantola Fuzato,23,Serie A,Goalkeeper,Roma,90,0,90,1,0,1,0,0,0,0,0,1,0,1,0,0,0,0,0,0,0,90,0
Daniel Maldini,19,Serie A,Forward,AC Milan,25,25,0,2,2,0,0,0,0,0,0,0,0,0,0,0,0,0,0,0,0,13,0
Daniele Baselli,28,Serie A,Midfielder,Torino,1288,649,639,16,8,8,0,0,0,2,0,22,8,14,3,0.14,0.14,0,0,0,0,81,644
Daniele Dessena,33,Serie A,Midfielder,Brescia,1876,957,919,24,13,11,2,1,1,0,0,40,15,25,7,0.1,0,0.1,0.09,0.1,938,78,0
Daniele Gastaldello,37,Serie A,Defender,Brescia,389,193,196,8,3,5,0,0,0,0,0,9,4,5,1,0,0,0,0,0,0,49,0
Daniele Padelli,35,Serie A,Goalkeeper,Inter Milan,270,90,180,3,1,2,0,0,0,0,0,4,2,2,1,0,0,0,0,0,0,90,0
Daniele Ragatzu,29,Serie A,Forward,Cagliari,304,173,131,13,7,6,1,0,1,0,0,5,2,3,1,0.3,0,0.3,0,0.69,304,23,0
Daniele Rugani,26,Serie A,Defender,Juventus,687,283,404,10,5,5,0,0,0,0,0,14,4,10,2,0,0,0,0,0,0,69,0
Danilo,29,Serie A,Defender,Juventus,1441,713,728,22,10,12,2,1,1,0,0,25,11,14,4,0.12,0,0.12,0.13,0.12,721,66,0
Danilo Cataldi,26,Serie A,Midfielder,Lazio,577,284,293,21,11,10,1,0,1,0,0,5,1,4,3,0.16,0,0.16,0,0.31,577,27,0
Danilo D'Ambrosio,32,Serie A,Defender,Inter Milan,1399,778,621,22,11,11,4,3,1,0,0,8,6,2,6,0.26,0,0.26,0.35,0.14,350,64,0
Danilo Larangeira,36,Serie A,Defender,Bologna,2642,1438,1204,30,16,14,2,0,2,0,0,44,21,23,11,0.07,0,0.07,0,0.15,1321,88,0
Daouda Peeters,21,Serie A,Midfielder,Juventus,14,0,14,1,0,1,0,0,0,0,0,0,0,0,0,0,0,0,0,0,0,14,0
Darko Lazović,30,Serie A,Midfielder,Hellas Verona,3247,1580,1667,38,19,19,3,1,2,7,0,43,21,22,4,0.28,0.19,0.08,0.06,0.11,1082,85,464
David Heidenreich,20,Serie A,Defender,Atalanta,0,0,0,0,0,0,0,0,0,0,0,0,0,0,0,0,0,0,0,0,0,0,0
David Ospina Ramírez,32,Serie A,Goalkeeper,Napoli,1470,900,570,17,10,7,0,0,0,0,0,16,12,4,0,0,0,0,0,0,0,86,0
Davide Biraschi,26,Serie A,Defender,Genoa,2007,896,1111,24,11,13,0,0,0,1,0,39,17,22,4,0.04,0.04,0,0,0,0,84,2007
Davide Calabria,23,Serie A,Defender,AC Milan,1619,910,709,25,14,11,1,1,0,1,0,20,8,12,5,0.11,0.06,0.06,0.1,0,1619,65,1619
Davide Faraoni,29,Serie A,Defender,Hellas Verona,3229,1699,1530,36,19,17,5,2,3,3,0,39,21,18,6,0.22,0.08,0.14,0.11,0.18,646,90,1076
Davide Riccardi,24,Serie A,Defender,Lecce,19,19,0,1,1,0,0,0,0,0,0,1,1,0,0,0,0,0,0,0,0,19,0
Davide Santon,29,Serie A,Defender,Roma,616,175,441,15,6,9,0,0,0,0,0,11,4,7,4,0,0,0,0,0,0,41,0
Davide Zappacosta,28,Serie A,Defender,Roma,446,92,354,9,4,5,0,0,0,1,0,7,1,6,0,0.2,0.2,0,0,0,0,50,446
Dejan Kulusevski,20,Serie A,Midfielder,Parma,2937,1493,1444,36,19,17,10,5,5,8,1,50,20,30,3,0.55,0.25,0.31,0.3,0.31,294,82,367
Demba Thiam,22,Serie A,Goalkeeper,SPAL,180,180,0,2,2,0,0,0,0,0,0,3,3,0,0,0,0,0,0,0,0,90,0
Denilho Cleonise,18,Serie A,Forward,Genoa,43,2,41,4,1,3,0,0,0,0,0,0,0,0,2,0,0,0,0,0,0,11,0
Denis Portanova,19,Serie A,Defender,Bologna,0,0,0,0,0,0,0,0,0,0,0,0,0,0,0,0,0,0,0,0,0,0,0
Denis Vavro,24,Serie A,Defender,Lazio,318,90,228,11,5,6,0,0,0,0,0,4,2,2,0,0,0,0,0,0,0,29,0
Diego Abbrandini,19,Serie A,Goalkeeper,Brescia,0,0,0,0,0,0,0,0,0,0,0,0,0,0,0,0,0,0,0,0,0,0,0
Diego da Silva Farias,30,Serie A,Forward,Lecce,832,338,494,18,9,9,2,1,1,0,0,20,10,10,3,0.22,0,0.22,0.27,0.18,416,46,0
Diego Demme,28,Serie A,Midfielder,Napoli,904,318,586,15,7,8,1,0,1,0,0,14,6,8,6,0.1,0,0.1,0,0.15,904,60,0
Diego Godín,34,Serie A,Defender,Inter Milan,1629,849,780,23,12,11,1,1,0,1,0,14,8,6,5,0.11,0.06,0.06,0.11,0,1629,71,1629
Diego Laxalt,27,Serie A,Midfielder,Torino,755,364,391,20,9,11,0,0,0,1,0,14,7,7,4,0.12,0.12,0,0,0,0,38,755
Diego Perotti,32,Serie A,Forward,Roma,873,447,426,21,11,10,5,2,3,3,4,15,9,6,4,0.82,0.31,0.52,0.4,0.63,175,42,291
Dimitri Bisoli,26,Serie A,Midfielder,Brescia,2154,1014,1140,25,12,13,1,1,0,1,0,39,18,21,6,0.08,0.04,0.04,0.09,0,2154,86,2154
Dion Ruffo Luci,19,Serie A,Midfielder,Bologna,0,0,0,1,0,1,0,0,0,0,0,0,0,0,0,0,0,0,0,0,0,0,0
Djavan Anderson,25,Serie A,Defender,Lazio,165,23,142,6,2,4,0,0,0,0,0,3,0,3,1,0,0,0,0,0,0,28,0
Domenico Berardi,26,Serie A,Forward,Sassuolo,2504,1408,1096,31,17,14,14,9,5,10,2,43,28,15,7,0.86,0.36,0.5,0.58,0.41,179,81,250
Domenico Criscito,33,Serie A,Defender,Genoa,2055,900,1155,26,12,14,8,3,5,0,8,40,13,27,7,0.35,0,0.35,0.3,0.39,257,79,0
Douglas Costa,30,Serie A,Midfielder,Juventus,792,464,328,23,12,11,1,0,1,4,0,7,4,3,1,0.57,0.45,0.11,0,0.27,792,34,198
Dries Mertens,33,Serie A,Forward,Napoli,1686,816,870,31,16,15,9,5,4,7,0,27,11,16,5,0.85,0.37,0.48,0.55,0.41,187,54,241
Drissa Camara,18,Serie A,Midfielder,Parma,0,0,0,0,0,0,0,0,0,0,0,0,0,0,0,0,0,0,0,0,0,0,0
Dušan Vlahović,20,Serie A,Forward,Fiorentina,1488,699,789,30,14,16,6,1,5,0,1,27,12,15,5,0.36,0,0.36,0.13,0.57,248,50,0
Duván Zapata,29,Serie A,Forward,Atalanta,2037,986,1051,28,14,14,18,6,12,6,1,28,15,13,1,1.06,0.27,0.8,0.55,1.03,113,73,340
Ebrima Colley,20,Serie A,Midfielder,Atalanta,77,70,7,5,3,2,0,0,0,1,0,1,1,0,1,1.17,1.17,0,0,0,0,15,77
Ebrima Darboe,19,Serie A,Midfielder,Roma,0,0,0,0,0,0,0,0,0,0,0,0,0,0,0,0,0,0,0,0,0,0,0
Eddy Anthony Salcedo Mora,19,Serie A,Forward,Hellas Verona,677,373,304,17,9,8,1,1,0,0,0,5,2,3,0,0.13,0,0.13,0.24,0,677,40,0
Édgar Barreto,36,Serie A,Midfielder,Sampdoria,90,46,44,2,1,1,0,0,0,0,0,2,1,1,0,0,0,0,0,0,0,45,0
Edgaras Dubickas,22,Serie A,Midfielder,Lecce,2,2,0,1,1,0,0,0,0,0,0,0,0,0,0,0,0,0,0,0,0,2,0
Edin Džeko,34,Serie A,Forward,Roma,2854,1628,1226,35,19,16,16,9,7,7,0,41,25,16,4,0.73,0.22,0.5,0.5,0.51,178,82,408
Edoardo Corvi,19,Serie A,Goalkeeper,Parma,0,0,0,0,0,0,0,0,0,0,0,0,0,0,0,0,0,0,0,0,0,0,0
Edoardo Goldaniga,27,Serie A,Defender,Genoa,780,386,394,13,6,7,1,1,0,0,0,20,7,13,4,0.12,0,0.12,0.23,0,780,60,0
Edoardo Vergani,19,Serie A,Forward,Inter Milan,0,0,0,0,0,0,0,0,0,0,0,0,0,0,0,0,0,0,0,0,0,0,0
Eljif Elmas,21,Serie A,Midfielder,Napoli,1128,343,785,26,12,14,1,0,1,1,0,13,3,10,7,0.16,0.08,0.08,0,0.11,1128,43,1128
Elseid Hysaj,26,Serie A,Defender,Napoli,1484,719,765,20,9,11,1,1,0,2,0,15,7,8,3,0.18,0.12,0.06,0.13,0,1484,74,742
Emanuele Ndoj,23,Serie A,Midfielder,Brescia,549,281,268,18,9,9,0,0,0,0,0,12,5,7,2,0,0,0,0,0,0,31,0
Emanuele Torrasi,21,Serie A,Midfielder,AC Milan,0,0,0,0,0,0,0,0,0,0,0,0,0,0,0,0,0,0,0,0,0,0,0
Emil Audero Mulyadi,23,Serie A,Goalkeeper,Sampdoria,3240,1620,1620,36,18,18,0,0,0,0,0,58,25,33,1,0,0,0,0,0,0,90,0
Emiliano Ariel Rigoni,27,Serie A,Midfielder,Sampdoria,429,264,165,8,4,4,0,0,0,1,0,7,3,4,2,0.21,0.21,0,0,0,0,54,429
Emin Ghazoini,19,Serie A,Defender,Torino,0,0,0,0,0,0,0,0,0,0,0,0,0,0,0,0,0,0,0,0,0,0,0
Emmanuel Agyemang-Badu,29,Serie A,Midfielder,Hellas Verona,223,99,124,10,5,5,0,0,0,0,0,5,1,4,2,0,0,0,0,0,0,22,0
Emre Can,26,Serie A,Midfielder,Juventus,280,120,160,8,4,4,0,0,0,0,0,8,5,3,2,0,0,0,0,0,0,35,0
Enrico Alfonso,32,Serie A,Goalkeeper,Brescia,280,270,10,4,3,1,0,0,0,0,0,4,4,0,0,0,0,0,0,0,0,70,0
Enrico Brignola,21,Serie A,Forward,Sassuolo,0,0,0,0,0,0,0,0,0,0,0,0,0,0,0,0,0,0,0,0,0,0,0
Enrico Oviszach,19,Serie A,Midfielder,Udinese,0,0,0,0,0,0,0,0,0,0,0,0,0,0,0,0,0,0,0,0,0,0,0
Eric Lirussi,19,Serie A,Forward,Udinese,0,0,0,0,0,0,0,0,0,0,0,0,0,0,0,0,0,0,0,0,0,0,0
Erick Pulgar,31,Serie A,Forward,Fiorentina,2946,1639,1307,37,19,18,7,2,5,6,7,41,22,19,9,0.4,0.18,0.21,0.11,0.34,421,80,491
Ernesto Torregrossa,28,Serie A,Forward,Brescia,1853,957,896,25,12,13,7,4,3,3,2,44,15,29,8,0.49,0.15,0.34,0.38,0.3,265,74,618
Ervin Zukanović,33,Serie A,Defender,SPAL,203,90,113,3,1,2,0,0,0,0,0,4,2,2,1,0,0,0,0,0,0,68,0
Etrit Berisha,31,Serie A,Goalkeeper,SPAL,2340,1080,1260,26,12,14,0,0,0,0,0,41,18,23,2,0,0,0,0,0,0,90,0
Evgeniy Shakhov,29,Serie A,Midfielder,Lecce,1076,529,547,24,14,10,1,1,0,2,0,25,12,13,3,0.25,0.17,0.08,0.17,0,1076,45,538
Fabián,24,Serie A,Midfielder,Napoli,2689,1475,1214,33,17,16,3,1,2,6,0,34,16,18,2,0.3,0.2,0.1,0.06,0.15,896,81,448
Fabio Borini,29,Serie A,Forward,Hellas Verona,880,436,444,16,8,8,3,1,2,0,1,8,7,1,3,0.31,0,0.31,0.21,0.41,293,55,0
Fabio Ceravolo,33,Serie A,Forward,Parma,0,0,0,0,0,0,0,0,0,0,0,0,0,0,0,0,0,0,0,0,0,0,0
Fabio Depaoli,23,Serie A,Midfielder,Sampdoria,1853,819,1034,29,14,15,0,0,0,1,0,28,11,17,7,0.05,0.05,0,0,0,0,64,1853
Fabio Lucioni,33,Serie A,Defender,Lecce,3134,1620,1514,36,18,18,3,1,2,0,0,71,38,33,9,0.09,0,0.09,0.06,0.12,1045,87,0
Fabio Pisacane,34,Serie A,Defender,Cagliari,2446,1284,1162,30,15,15,1,1,0,0,0,37,21,16,8,0.04,0,0.04,0.07,0,2446,82,0
Fabio Porru,20,Serie A,Defender,Cagliari,0,0,0,0,0,0,0,0,0,0,0,0,0,0,0,0,0,0,0,0,0,0,0
Fabio Quagliarella,37,Serie A,Forward,Sampdoria,2284,1235,1049,28,16,12,11,5,6,3,5,42,22,20,2,0.55,0.12,0.43,0.36,0.51,208,82,761
Fabrizio Alastra,23,Serie A,Goalkeeper,Parma,0,0,0,0,0,0,0,0,0,0,0,0,0,0,0,0,0,0,0,0,0,0,0
Fabrizio Cacciatore,34,Serie A,Defender,Cagliari,1155,453,702,16,6,10,0,0,0,0,0,15,8,7,2,0,0,0,0,0,0,72,0
Faouzi Ghoulam,29,Serie A,Defender,Napoli,371,112,259,9,3,6,0,0,0,1,0,5,1,4,2,0.24,0.24,0,0,0,0,41,371
Federico Bernardeschi,26,Serie A,Forward,Juventus,1575,662,913,29,13,16,1,1,0,1,0,23,9,14,6,0.11,0.06,0.06,0.14,0,1575,54,1575
Federico Bonazzoli,23,Serie A,Forward,Sampdoria,739,347,392,19,10,9,6,3,3,0,0,9,5,4,1,0.73,0,0.73,0.78,0.69,123,39,0
Federico Bonini,19,Serie A,Defender,Bologna,6,0,6,1,0,1,0,0,0,0,0,1,0,1,0,0,0,0,0,0,0,6,0
Federico Brancolini,19,Serie A,Goalkeeper,Fiorentina,5,5,0,1,1,0,0,0,0,0,0,0,0,0,0,0,0,0,0,0,0,5,0
Federico Ceccherini,28,Serie A,Defender,Fiorentina,830,349,481,15,6,9,0,0,0,0,0,13,5,8,3,0,0,0,0,0,0,55,0
Federico Chiesa,23,Serie A,Forward,Fiorentina,2649,1372,1277,34,17,17,10,6,4,6,1,31,16,15,7,0.54,0.2,0.34,0.39,0.28,265,78,442
Federico Di Francesco,26,Serie A,Forward,SPAL,1084,601,483,20,12,8,2,2,0,0,0,25,14,11,4,0.17,0,0.17,0.3,0,542,54,0
Federico Dimarco,23,Serie A,Defender,Hellas Verona,540,269,271,16,10,6,0,0,0,3,0,8,4,4,1,0.5,0.5,0,0,0,0,34,180
Federico Fazio,33,Serie A,Defender,Roma,1215,509,706,16,6,10,1,0,1,0,0,20,9,11,3,0.07,0,0.07,0,0.13,1215,76,0
Federico Javier Santander Mereles,29,Serie A,Forward,Bologna,753,291,462,24,12,12,1,0,1,0,1,9,2,7,6,0.12,0,0.12,0,0.19,753,31,0
Federico Marchetti,37,Serie A,Goalkeeper,Genoa,0,0,0,0,0,0,0,0,0,0,0,0,0,0,2,0,0,0,0,0,0,0,0
Federico Marigosu,19,Serie A,Midfielder,Cagliari,22,11,11,2,1,1,0,0,0,0,0,0,0,0,0,0,0,0,0,0,0,11,0
Federico Mattiello,25,Serie A,Defender,Cagliari,925,386,539,18,7,11,0,0,0,1,0,8,1,7,3,0.1,0.1,0,0,0,0,51,925
Federico Peluso,36,Serie A,Defender,Sassuolo,1511,1113,398,23,14,9,0,0,0,2,0,34,25,9,6,0.12,0.12,0,0,0,0,66,756
Federico Zanchetta,18,Serie A,Midfielder,SPAL,0,0,0,0,0,0,0,0,0,0,0,0,0,0,0,0,0,0,0,0,0,0,0
Felice D'Amico,20,Serie A,Forward,Sampdoria,1,1,0,2,1,1,0,0,0,0,0,0,0,0,0,0,0,0,0,0,0,1,0
Felipe Castaldo Curcio,27,Serie A,Midfielder,Brescia,4,0,4,1,0,1,0,0,0,0,0,0,0,0,0,0,0,0,0,0,0,4,0
Felipe dal Belo,36,Serie A,Defender,SPAL,997,438,559,15,7,8,0,0,0,0,0,26,15,11,5,0,0,0,0,0,0,66,0
Felipe Salvador Caicedo Corozo,32,Serie A,Forward,Lazio,1411,666,745,30,14,16,9,5,4,2,0,14,4,10,7,0.7,0.13,0.57,0.68,0.48,157,47,706
Fernando Llorente Torres,35,Serie A,Forward,Napoli,490,280,210,17,10,7,3,1,2,1,0,6,5,1,1,0.73,0.18,0.55,0.32,0.86,163,29,490
Filip Jagiełło,23,Serie A,Midfielder,Genoa,552,305,247,11,5,6,0,0,0,2,0,12,5,7,0,0.33,0.33,0,0,0,0,50,276
Filip Stankovic,18,Serie A,Goalkeeper,Inter Milan,0,0,0,0,0,0,0,0,0,0,0,0,0,0,0,0,0,0,0,0,0,0,0
Filip Đuričić,28,Serie A,Midfielder,Sassuolo,1638,859,779,29,16,13,5,4,1,5,0,23,11,12,6,0.55,0.27,0.27,0.42,0.12,328,56,328
Filippo Falco,28,Serie A,Midfielder,Lecce,2020,1017,1003,30,15,15,4,3,1,6,0,40,20,20,0,0.45,0.27,0.18,0.27,0.09,505,67,337
Filippo Romagna,23,Serie A,Defender,Sassuolo,1476,741,735,18,9,9,0,0,0,0,0,19,10,9,3,0,0,0,0,0,0,82,0
Filippo Terracciano,17,Serie A,Midfielder,Hellas Verona,0,0,0,0,0,0,0,0,0,0,0,0,0,0,0,0,0,0,0,0,0,0,0
Flavio Junior Bianchi,20,Serie A,Forward,Genoa,0,0,0,0,0,0,0,0,0,0,0,0,0,0,0,0,0,0,0,0,0,0,0
Florian Aye,23,Serie A,Forward,Brescia,1379,611,768,22,9,13,0,0,0,0,0,26,12,14,4,0,0,0,0,0,0,63,0
Francesco Acerbi,32,Serie A,Defender,Lazio,3166,1593,1573,36,18,18,2,1,1,2,0,36,15,21,4,0.11,0.06,0.06,0.06,0.06,1583,88,1583
Francesco Caputo,33,Serie A,Forward,Sassuolo,2936,1563,1373,36,18,18,21,14,7,7,2,46,25,21,3,0.86,0.21,0.64,0.81,0.46,140,82,419
Francesco Cassata,23,Serie A,Midfielder,Genoa,1463,717,746,24,12,12,2,1,1,0,0,32,15,17,12,0.12,0,0.12,0.13,0.12,732,61,0
Francesco Magnanelli,35,Serie A,Midfielder,Sassuolo,1393,620,773,22,13,9,0,0,0,0,0,19,12,7,5,0,0,0,0,0,0,63,0
Francesco Mazzolo,19,Serie A,Defender,Udinese,0,0,0,0,0,0,0,0,0,0,0,0,0,0,0,0,0,0,0,0,0,0,0
Francesco Rossi,29,Serie A,Goalkeeper,Atalanta,10,10,0,1,1,0,0,0,0,0,0,1,1,0,0,0,0,0,0,0,0,10,0
Francesco Vicari,26,Serie A,Defender,SPAL,2901,1595,1306,34,18,16,0,0,0,0,0,55,31,24,4,0,0,0,0,0,0,85,0
Francisco Sierralta Carvallo,23,Serie A,Forward,Udinese,0,0,0,0,0,0,0,0,0,0,0,0,0,0,0,0,0,0,0,0,0,0,0
Franck Ribery,37,Serie A,Midfielder,Fiorentina,1425,718,707,21,11,10,3,0,3,3,0,12,6,6,3,0.38,0.19,0.19,0,0.38,475,68,475
Franck Yannick Kessié,23,Serie A,Midfielder,AC Milan,2910,1396,1514,35,17,18,4,2,2,1,2,37,14,23,3,0.15,0.03,0.12,0.13,0.12,728,83,2910
Gabriel Boloca,19,Serie A,Defender,Bologna,0,0,0,0,0,0,0,0,0,0,0,0,0,0,0,0,0,0,0,0,0,0,0
Gabriel Tadeu Strefezza Rebelato,23,Serie A,Midfielder,SPAL,2117,1113,1004,32,17,15,1,0,1,2,0,48,22,26,9,0.13,0.09,0.04,0,0.09,2117,66,1059
Gabriel Vasconelos Ferreira,28,Serie A,Goalkeeper,Lecce,2998,1530,1468,34,17,17,0,0,0,0,0,73,39,34,4,0,0,0,0,0,0,88,0
Gabriele Corbo,20,Serie A,Defender,Bologna,121,0,121,2,0,2,0,0,0,0,0,4,0,4,1,0,0,0,0,0,0,61,0
Gabriele Moncini,24,Serie A,Forward,SPAL,154,66,88,4,2,2,0,0,0,0,0,1,0,1,0,0,0,0,0,0,0,39,0
Gaetano Castrovilli,23,Serie A,Midfielder,Fiorentina,2684,1506,1178,33,18,15,3,1,2,2,0,36,21,15,10,0.17,0.07,0.1,0.06,0.15,895,81,1342
Gary Alexis Medel Soto,33,Serie A,Defender,Bologna,1796,986,810,23,13,10,0,0,0,0,0,27,17,10,11,0,0,0,0,0,0,78,0
Gastón Brugman,28,Serie A,Midfielder,Parma,1463,801,662,23,12,11,0,0,0,2,0,25,14,11,5,0.12,0.12,0,0,0,0,64,732
Gastón Ramírez,29,Serie A,Midfielder,Sampdoria,1401,638,763,26,12,14,7,2,5,2,3,30,11,19,5,0.58,0.13,0.45,0.28,0.59,200,54,701
Gastón Rodrigo Pereiro López,25,Serie A,Forward,Cagliari,346,181,165,10,6,4,1,1,0,0,0,9,3,6,3,0.26,0,0.26,0.5,0,346,35,0
Gennaro Tutino,24,Serie A,Forward,Hellas Verona,223,98,125,6,2,4,0,0,0,0,0,3,1,2,0,0,0,0,0,0,0,37,0
Georgi Tunjov,19,Serie A,Midfielder,SPAL,280,31,249,10,4,6,0,0,0,0,0,8,1,7,0,0,0,0,0,0,0,28,0
Germán Pezzella,29,Serie A,Defender,Fiorentina,2833,1433,1400,33,16,17,3,3,0,1,0,37,20,17,12,0.13,0.03,0.1,0.19,0,944,86,2833
Gervais Lombe Yao Kouassi,33,Serie A,Forward,Parma,2280,1159,1121,31,16,15,7,2,5,4,0,33,15,18,3,0.43,0.16,0.28,0.16,0.4,326,74,570
Giacomo Bonaventura,31,Serie A,Midfielder,AC Milan,1327,685,642,29,15,14,3,1,2,5,0,12,4,8,2,0.54,0.34,0.2,0.13,0.28,442,46,265
Giacomo Manzari,20,Serie A,Forward,Sassuolo,13,11,2,3,1,2,0,0,0,0,0,0,0,0,0,0,0,0,0,0,0,4,0
Giacomo Olzer,19,Serie A,Midfielder,AC Milan,0,0,0,0,0,0,0,0,0,0,0,0,0,0,0,0,0,0,0,0,0,0,0
Giacomo Raspadori,20,Serie A,Forward,Sassuolo,257,102,155,11,5,6,2,1,1,0,0,3,2,1,0,0.7,0,0.7,0.88,0.58,129,23,0
Giacomo Ricci,24,Serie A,Defender,Parma,0,0,0,0,0,0,0,0,0,0,0,0,0,0,0,0,0,0,0,0,0,0,0
Giacomo Vrioni,22,Serie A,Forward,Juventus,11,11,0,1,1,0,0,0,0,0,0,0,0,0,0,0,0,0,0,0,0,11,0
Giampaolo Pazzini,36,Serie A,Forward,Hellas Verona,294,112,182,15,7,8,4,3,1,0,3,2,0,2,0,1.22,0,1.22,2.41,0.49,74,20,0
Giangiacomo Magnani,25,Serie A,Defender,Sassuolo,253,168,85,10,3,7,1,0,1,0,0,8,7,1,3,0.36,0,0.36,0,1.06,253,25,0
Gianluca Caprari,27,Serie A,Forward,Parma,1249,625,624,30,14,16,5,3,2,0,1,26,9,17,5,0.36,0,0.36,0.43,0.29,250,42,0
Gianluca Frabotta,21,Serie A,Defender,Juventus,90,90,0,1,1,0,0,0,0,0,0,3,3,0,0,0,0,0,0,0,0,90,0
Gianluca Gaetano,20,Serie A,Midfielder,Napoli,0,0,0,0,0,0,0,0,0,0,0,0,0,0,0,0,0,0,0,0,0,0,0
Gianluca Lapadula,30,Serie A,Forward,Lecce,1786,849,937,25,12,13,11,6,5,0,2,44,19,25,9,0.55,0,0.55,0.64,0.48,162,71,0
Gianluca Mancini,24,Serie A,Defender,Roma,2743,1284,1459,32,15,17,1,1,0,0,0,38,19,19,16,0.03,0,0.03,0.07,0,2743,86,0
Gianluca Pegolo,39,Serie A,Goalkeeper,Sassuolo,450,90,360,5,1,4,0,0,0,0,0,2,1,1,0,0,0,0,0,0,0,90,0
Gianluigi Buffon,42,Serie A,Goalkeeper,Juventus,810,630,180,9,7,2,0,0,0,0,0,9,6,3,0,0,0,0,0,0,0,90,0
Gianluigi Donnarumma,21,Serie A,Goalkeeper,AC Milan,3202,1620,1582,36,18,18,0,0,0,0,0,40,17,23,3,0,0,0,0,0,0,89,0
Gianmarco Cangiano,19,Serie A,Forward,Bologna,18,15,3,3,2,1,0,0,0,0,0,1,0,1,0,0,0,0,0,0,0,6,0
Gianmarco Chironi,23,Serie A,Goalkeeper,Lecce,0,0,0,0,0,0,0,0,0,0,0,0,0,0,0,0,0,0,0,0,0,0,0
Gianmarco Ferrari,28,Serie A,Defender,Sassuolo,1896,814,1082,23,10,13,0,0,0,1,0,28,11,17,5,0.05,0.05,0,0,0,0,82,1896
Giannelli Imbula,28,Serie A,Midfielder,Lecce,129,27,102,3,1,2,0,0,0,0,0,3,0,3,0,0,0,0,0,0,0,43,0
Giorgio Chiellini,36,Serie A,Defender,Juventus,203,12,191,4,1,3,1,0,1,0,0,1,0,1,0,0.44,0,0.44,0,0.47,203,51,0
Giorgos Kiriakopoulos,24,Serie A,Defender,Sassuolo,1637,809,828,26,12,14,0,0,0,1,0,24,11,13,4,0.05,0.05,0,0,0,0,63,1637
Giovanni Di Lorenzo,27,Serie A,Defender,Napoli,2970,1530,1440,33,17,16,3,2,1,3,0,40,19,21,5,0.18,0.09,0.09,0.12,0.06,990,90,990
Giovanni Simeone,25,Serie A,Forward,Cagliari,2937,1390,1547,37,18,19,12,7,5,3,0,38,15,23,4,0.46,0.09,0.37,0.45,0.29,245,79,979
Giulio Donati,30,Serie A,Defender,Lecce,1762,900,862,20,10,10,1,1,0,0,0,43,20,23,4,0.05,0,0.05,0.1,0,1762,88,0
Giuseppe Aurelio,20,Serie A,Defender,Sassuolo,0,0,0,0,0,0,0,0,0,0,0,0,0,0,0,0,0,0,0,0,0,0,0
Giuseppe Ciocci,18,Serie A,Goalkeeper,Cagliari,0,0,0,0,0,0,0,0,0,0,0,0,0,0,0,0,0,0,0,0,0,0,0
Giuseppe Pezzella,22,Serie A,Defender,Parma,1024,505,519,23,13,10,0,0,0,0,0,20,9,11,2,0,0,0,0,0,0,45,0
Gleison Bremer Silva Nascimento,23,Serie A,Defender,Torino,2276,1091,1185,27,13,14,3,1,2,1,0,41,15,26,6,0.16,0.04,0.12,0.08,0.15,759,84,2276
Gonzalo Higuain,32,Serie A,Forward,Juventus,1867,886,981,32,16,16,8,4,4,4,0,24,9,15,2,0.58,0.19,0.39,0.41,0.37,233,58,467
Gonzalo Maroni,21,Serie A,Midfielder,Sampdoria,178,66,112,5,2,3,0,0,0,1,0,4,3,1,0,0.51,0.51,0,0,0,0,36,178
Gonzalo Villar del Fraile,22,Serie A,Midfielder,Roma,292,34,258,9,3,6,0,0,0,0,0,5,1,4,3,0,0,0,0,0,0,32,0
Goran Pandev,37,Serie A,Forward,Genoa,1682,845,837,34,17,17,9,6,3,1,0,31,13,18,6,0.54,0.05,0.48,0.64,0.32,187,49,1682
Gregoire Defrel,29,Serie A,Forward,Sassuolo,977,376,601,17,8,9,3,1,2,3,1,19,8,11,1,0.55,0.28,0.28,0.24,0.3,326,57,326
Guido Guerrieri,24,Serie A,Goalkeeper,Lazio,0,0,0,0,0,0,0,0,0,0,0,0,0,0,0,0,0,0,0,0,0,0,0
Guilherme Antonio Arana Lopes,23,Serie A,Defender,Atalanta,76,16,60,4,2,2,0,0,0,0,0,1,0,1,0,0,0,0,0,0,0,19,0
Hakan Çalhanoğlu,26,Serie A,Midfielder,AC Milan,2718,1216,1502,35,16,19,9,7,2,9,1,39,15,24,6,0.6,0.3,0.3,0.52,0.12,302,78,302
Hamed Junior Traorè,20,Serie A,Midfielder,Sassuolo,1575,686,889,31,15,16,4,3,1,1,0,22,9,13,3,0.29,0.06,0.23,0.39,0.1,394,51,1575
Hans Hateboer,26,Serie A,Defender,Atalanta,2353,984,1369,32,14,18,0,0,0,4,0,29,14,15,10,0.15,0.15,0,0,0,0,74,588
Henrikh Mkhitaryan,31,Serie A,Midfielder,Roma,1534,805,729,22,12,10,9,6,3,5,0,23,13,10,5,0.82,0.29,0.53,0.67,0.37,170,70,307
Hernani,35,Serie A,Midfielder,Parma,2421,1128,1293,32,15,17,0,0,0,4,0,40,14,26,10,0.15,0.15,0,0,0,0,76,605
Hidde ter Avest,23,Serie A,Defender,Udinese,677,480,197,20,11,9,0,0,0,0,0,14,10,4,1,0,0,0,0,0,0,34,0
Hirving Rodrigo Lozano Bahena,25,Serie A,Forward,Napoli,1018,494,524,26,13,13,4,0,4,1,0,9,5,4,3,0.44,0.09,0.35,0,0.69,255,39,1018
Hubert Dawid Idasiak,18,Serie A,Goalkeeper,Napoli,0,0,0,0,0,0,0,0,0,0,0,0,0,0,0,0,0,0,0,0,0,0,0
Iago Falqué Silva,30,Serie A,Forward,Genoa,620,287,333,14,7,7,2,1,1,1,2,12,4,8,0,0.44,0.15,0.29,0.31,0.27,310,44,620
Ibrahima M'baye,25,Serie A,Defender,Bologna,1506,783,723,20,10,10,0,0,0,3,0,26,11,15,5,0.18,0.18,0,0,0,0,75,502
Ignacio Pussetto,24,Serie A,Midfielder,Udinese,333,224,109,12,7,5,1,0,1,0,0,7,3,4,1,0.27,0,0.27,0,0.83,333,28,0
Igor Julio dos Santos de Paulo,22,Serie A,Defender,Fiorentina,1949,862,1087,26,13,13,0,0,0,1,0,32,14,18,9,0.05,0.05,0,0,0,0,75,1949
Ilario Monterisi,18,Serie A,Defender,Lecce,2,2,0,1,1,0,0,0,0,0,0,0,0,0,0,0,0,0,0,0,0,2,0
Ilija Nestorovski,30,Serie A,Forward,Udinese,1248,649,599,28,13,15,3,1,2,1,0,15,7,8,4,0.29,0.07,0.22,0.14,0.3,416,45,1248
Ionuț Andrei Radu,23,Serie A,Goalkeeper,Parma,1530,720,810,17,8,9,0,0,0,1,0,32,9,23,1,0.06,0.06,0,0,0,0,90,1530
Isaias Del Pupo,19,Serie A,Midfielder,Cagliari,0,0,0,0,0,0,0,0,0,0,0,0,0,0,0,0,0,0,0,0,0,0,0
Ismael Bennacer,22,Serie A,Midfielder,AC Milan,2488,1169,1319,31,14,17,1,1,0,0,0,32,12,20,14,0.04,0,0.04,0.08,0,2488,80,0
Ivan Radovanović,32,Serie A,Midfielder,Genoa,1317,694,623,19,10,9,0,0,0,1,0,28,8,20,3,0.07,0.07,0,0,0,0,69,1317
Jacob Rasmussen,23,Serie A,Defender,Fiorentina,0,0,0,0,0,0,0,0,0,0,0,0,0,0,0,0,0,0,0,0,0,0,0
Jacopo Da Riva,20,Serie A,Midfielder,Atalanta,0,0,0,1,1,0,0,0,0,0,0,0,0,0,0,0,0,0,0,0,0,0,0
Jacopo Pellegrini,20,Serie A,Forward,Sassuolo,0,0,0,0,0,0,0,0,0,0,0,0,0,0,0,0,0,0,0,0,0,0,0
Jacopo Petriccione,25,Serie A,Midfielder,Lecce,2141,1097,1044,31,15,16,0,0,0,5,0,45,25,20,10,0.21,0.21,0,0,0,0,69,428
Jacopo Sala,28,Serie A,Defender,SPAL,848,463,385,16,8,8,0,0,0,0,0,16,9,7,1,0,0,0,0,0,0,53,0
Jakub Iskra,18,Serie A,Defender,SPAL,76,32,44,2,1,1,0,0,0,0,0,1,0,1,0,0,0,0,0,0,0,38,0
Jakub Jankto,24,Serie A,Midfielder,Sampdoria,2103,1167,936,30,15,15,2,2,0,4,0,38,18,20,8,0.26,0.17,0.09,0.15,0,1052,70,526
Jan Kubala,20,Serie A,Midfielder,Udinese,0,0,0,0,0,0,0,0,0,0,0,0,0,0,0,0,0,0,0,0,0,0,0
Jandrei Chitolina Carniel,27,Serie A,Goalkeeper,Genoa,0,0,0,0,0,0,0,0,0,0,0,0,0,0,0,0,0,0,0,0,0,0,0
Jaromír Zmrhal,27,Serie A,Midfielder,Brescia,1120,560,560,21,11,10,2,2,0,0,0,29,12,17,0,0.16,0,0.16,0.32,0,560,53,0
Jasmin Kurtič,31,Serie A,Midfielder,Parma,3076,1654,1422,36,19,17,4,3,1,1,0,51,26,25,10,0.15,0.03,0.12,0.16,0.06,769,85,3076
Jaume Cuéllar Mendoza,19,Serie A,Forward,SPAL,70,70,0,2,2,0,0,0,0,0,0,1,1,0,0,0,0,0,0,0,0,35,0
Javier Pastore,31,Serie A,Midfielder,Roma,512,263,249,11,6,5,0,0,0,1,0,4,3,1,0,0.18,0.18,0,0,0,0,47,512
Jawad El Yamiq,28,Serie A,Midfielder,Genoa,196,0,196,3,0,3,0,0,0,0,0,9,0,9,1,0,0,0,0,0,0,65,0
Jean Freddi Pascal Greco,19,Serie A,Midfielder,Torino,0,0,0,0,0,0,0,0,0,0,0,0,0,0,0,0,0,0,0,0,0,0,0
Jeison Murillo,28,Serie A,Defender,Sampdoria,664,295,369,10,5,5,0,0,0,0,0,14,5,9,3,0,0,0,0,0,0,66,0
Jens Larsen,29,Serie A,Defender,Udinese,2796,1283,1513,33,16,17,1,0,1,3,0,29,12,17,5,0.13,0.1,0.03,0,0.06,2796,85,932
Jerdy Schouten,23,Serie A,Forward,Bologna,1083,491,592,19,9,10,0,0,0,0,0,22,8,14,7,0,0,0,0,0,0,57,0
Jeremie Boga,23,Serie A,Midfielder,Sassuolo,2522,1169,1353,34,17,17,11,9,2,2,0,40,23,17,0,0.46,0.07,0.39,0.69,0.13,229,74,1261
Jeremy Toljan,26,Serie A,Defender,Sassuolo,2188,1055,1133,29,14,15,1,0,1,2,0,29,14,15,8,0.12,0.08,0.04,0,0.08,2188,75,1094
Jesse Joronen,27,Serie A,Goalkeeper,Brescia,2610,1170,1440,29,13,16,0,0,0,0,0,54,21,33,1,0,0,0,0,0,0,90,0
Jhon Carlos Chancellor Cedeño,28,Serie A,Defender,Brescia,2246,1080,1166,26,12,14,3,2,1,0,0,44,19,25,3,0.12,0,0.12,0.17,0.08,749,86,0
João Pedro,27,Serie A,Midfielder,Cagliari,3156,1699,1457,36,19,17,18,12,6,4,4,44,24,20,6,0.63,0.11,0.51,0.64,0.37,175,88,789
Joaquin Correa,26,Serie A,Midfielder,Lazio,2005,903,1102,30,14,16,9,5,4,2,0,24,10,14,0,0.49,0.09,0.4,0.5,0.33,223,67,1003
Jony Rodríguez,29,Serie A,Midfielder,Lazio,1176,628,548,24,14,10,0,0,0,1,0,14,8,6,4,0.08,0.08,0,0,0,0,49,1176
Jordan Lukaku,26,Serie A,Defender,Lazio,385,156,229,13,5,8,0,0,0,2,0,3,1,2,2,0.47,0.47,0,0,0,0,30,193
Jordan Veretout,27,Serie A,Midfielder,Roma,2633,1467,1166,33,17,16,6,5,1,0,5,34,20,14,6,0.21,0,0.21,0.31,0.08,439,80,0
Jorge Filipe Soares Silva,21,Serie A,Defender,Lazio,0,0,0,0,0,0,0,0,0,0,0,0,0,0,0,0,0,0,0,0,0,0,0
José Callejón,33,Serie A,Forward,Napoli,2177,1331,846,33,17,16,4,3,1,7,0,32,17,15,2,0.45,0.29,0.17,0.2,0.11,544,66,311
José Luis Palomino,30,Serie A,Defender,Atalanta,2482,1178,1304,30,14,16,2,2,0,1,0,31,16,15,5,0.11,0.04,0.07,0.15,0,1241,83,2482
José Ndong Machín Dicombo,24,Serie A,Midfielder,Parma,0,0,0,0,0,0,0,0,0,0,0,0,0,0,0,0,0,0,0,0,0,0,0
Joseph Minala,24,Serie A,Midfielder,Lazio,0,0,0,0,0,0,0,0,0,0,0,0,0,0,0,0,0,0,0,0,0,0,0
Josip Iličić,32,Serie A,Midfielder,Atalanta,1672,836,836,26,13,13,15,9,6,5,0,23,12,11,2,1.08,0.27,0.81,0.97,0.65,111,64,334
Juan Agustín Musso,26,Serie A,Goalkeeper,Udinese,3420,1710,1710,38,19,19,0,0,0,0,0,46,21,25,1,0,0,0,0,0,0,90,0
Juan Cuadrado,32,Serie A,Midfielder,Juventus,2651,1440,1211,33,16,17,2,2,0,5,0,25,10,15,8,0.24,0.17,0.07,0.13,0,1326,80,530
Juan Jesus,40,Serie A,Midfielder,Roma,137,100,37,4,2,2,0,0,0,0,0,3,3,0,2,0,0,0,0,0,0,34,0
Julian Chabot,22,Serie A,Defender,Sampdoria,570,180,390,8,2,6,1,0,1,0,0,13,4,9,2,0.16,0,0.16,0,0.23,570,71,0
Júnior Costa,36,Serie A,Goalkeeper,Bologna,90,90,0,1,1,0,0,0,0,0,0,1,1,0,0,0,0,0,0,0,0,90,0
Juraj Kucka,33,Serie A,Midfielder,Parma,1934,995,939,26,13,13,6,2,4,3,2,27,11,16,6,0.42,0.14,0.28,0.18,0.38,322,74,645
Justin Kluivert,21,Serie A,Forward,Roma,1523,528,995,22,7,15,4,1,3,1,0,20,7,13,6,0.3,0.06,0.24,0.17,0.27,381,69,1523
Kaique Rocha Lima,19,Serie A,Defender,Sampdoria,0,0,0,0,0,0,0,0,0,0,0,0,0,0,0,0,0,0,0,0,0,0,0
Kalidou Koulibaly,29,Serie A,Defender,Napoli,2109,1119,990,25,14,11,0,0,0,0,0,33,15,18,8,0,0,0,0,0,0,84,0
Karlo Letica,23,Serie A,Goalkeeper,SPAL,900,450,450,10,5,5,0,0,0,0,0,25,13,12,1,0,0,0,0,0,0,90,0
Karol Linetty,25,Serie A,Midfielder,Sampdoria,2021,1112,909,28,16,12,4,3,1,3,0,41,24,17,4,0.31,0.13,0.18,0.24,0.1,505,72,674
Kastriot Dermaku,28,Serie A,Defender,Parma,1022,541,481,16,8,8,0,0,0,0,0,14,5,9,2,0,0,0,0,0,0,64,0
Ken Sema,27,Serie A,Midfielder,Udinese,2466,1405,1061,32,18,14,2,1,1,1,0,31,16,15,6,0.11,0.04,0.07,0.06,0.08,1233,77,2466
Kevin Andrés Agudelo Ardila,22,Serie A,Midfielder,Fiorentina,729,228,501,13,4,9,1,1,0,1,0,12,3,9,5,0.25,0.12,0.12,0.39,0,729,56,729
Kevin Bonifazi,24,Serie A,Defender,SPAL,1439,809,630,17,10,7,2,1,1,0,0,33,16,17,3,0.13,0,0.13,0.11,0.14,720,85,0
Kevin Lasagna,28,Serie A,Forward,Udinese,2573,1312,1261,36,18,18,10,6,4,1,0,37,18,19,1,0.38,0.03,0.35,0.41,0.29,257,71,2573
Kévin Malcuit,29,Serie A,Defender,Napoli,256,90,166,4,1,3,0,0,0,0,0,2,0,2,0,0,0,0,0,0,0,64,0
Kevin-Prince Boateng,33,Serie A,Midfielder,Fiorentina,596,396,200,14,8,6,1,1,0,0,0,11,7,4,2,0.15,0,0.15,0.23,0,596,43,0
Khadim Ndiaye,20,Serie A,Goalkeeper,Atalanta,0,0,0,0,0,0,0,0,0,0,0,0,0,0,0,0,0,0,0,0,0,0,0
Khouma Babacar,27,Serie A,Forward,Lecce,1427,704,723,25,11,14,3,2,1,0,0,32,16,16,3,0.19,0,0.19,0.26,0.12,476,57,0
Kingsley Dogo Michael,21,Serie A,Midfielder,Bologna,77,0,77,1,0,1,0,0,0,0,0,1,0,1,0,0,0,0,0,0,0,77,0
Konstantinos Manolas,29,Serie A,Defender,Napoli,2178,1098,1080,26,14,12,4,2,2,0,0,28,12,16,2,0.17,0,0.17,0.16,0.17,545,84,0
Koray Günter,26,Serie A,Defender,Hellas Verona,2735,1220,1515,32,15,17,0,0,0,0,0,37,18,19,7,0,0,0,0,0,0,85,0
Kristoffer Askildsen,19,Serie A,Midfielder,Sampdoria,74,48,26,4,2,2,1,1,0,0,0,0,0,0,2,1.22,0,1.22,1.88,0,74,19,0
Krisztofer Horváth,18,Serie A,Midfielder,SPAL,41,35,6,3,2,1,0,0,0,0,0,1,1,0,0,0,0,0,0,0,0,14,0
Krzysztof Piątek,25,Serie A,Forward,AC Milan,1190,598,592,18,9,9,4,1,3,0,3,15,6,9,1,0.3,0,0.3,0.15,0.46,298,66,0
Kwadwo Asamoah,31,Serie A,Midfielder,Inter Milan,639,288,351,8,4,4,0,0,0,1,0,5,2,3,1,0.14,0.14,0,0,0,0,80,639
Kwang-Song Han,22,Serie A,Forward,Juventus,0,0,0,0,0,0,0,0,0,0,0,0,0,0,0,0,0,0,0,0,0,0,0
Ladislav Krejčí,28,Serie A,Midfielder,Bologna,1050,522,528,14,8,6,1,1,0,0,0,19,9,10,1,0.09,0,0.09,0.17,0,1050,75,0
Lasse Schöne,34,Serie A,Forward,Genoa,2434,1356,1078,32,17,15,2,2,0,3,0,42,22,20,5,0.18,0.11,0.07,0.13,0,1217,76,811
Lautaro Javier Martínez,23,Serie A,Forward,Inter Milan,2466,1097,1369,35,17,18,14,8,6,3,2,28,13,15,9,0.62,0.11,0.51,0.66,0.39,176,70,822
Leandro Henrique do Nascimento,22,Serie A,Midfielder,Napoli,0,0,0,0,0,0,0,0,0,0,0,0,0,0,0,0,0,0,0,0,0,0,0
Lennart Czyborra,21,Serie A,Defender,Atalanta,16,16,0,1,1,0,0,0,0,0,0,1,1,0,0,0,0,0,0,0,0,16,0
Leonardo Bonucci,33,Serie A,Defender,Juventus,3085,1645,1440,35,19,16,3,3,0,0,0,34,15,19,10,0.09,0,0.09,0.16,0,1028,88,0
Leonardo Duarte da Silva,24,Serie A,Midfielder,AC Milan,403,223,180,6,4,2,0,0,0,0,0,6,4,2,2,0,0,0,0,0,0,67,0
Leonardo Mazza,20,Serie A,Midfielder,Bologna,0,0,0,0,0,0,0,0,0,0,0,0,0,0,0,0,0,0,0,0,0,0,0
Leonardo Morosini,25,Serie A,Midfielder,Brescia,23,5,18,3,1,2,0,0,0,0,0,0,0,0,0,0,0,0,0,0,0,8,0
Leonardo Pavoletti,31,Serie A,Forward,Cagliari,45,45,0,2,1,1,0,0,0,0,0,0,0,0,0,0,0,0,0,0,0,23,0
Leonardo Spinazzola,27,Serie A,Defender,Roma,1548,770,778,24,10,14,1,1,0,2,0,22,9,13,2,0.17,0.12,0.06,0.12,0,1548,65,774
Leonardo Stanzani,20,Serie A,Forward,Bologna,0,0,0,0,0,0,0,0,0,0,0,0,0,0,0,0,0,0,0,0,0,0,0
Lévy Koffi Djidji,27,Serie A,Defender,Torino,847,413,434,17,9,8,0,0,0,0,0,21,12,9,0,0,0,0,0,0,0,50,0
Liam Henderson,24,Serie A,Midfielder,Hellas Verona,195,94,101,4,2,2,0,0,0,0,0,3,1,2,1,0,0,0,0,0,0,49,0
Lorenzo Andrenacci,25,Serie A,Goalkeeper,Brescia,530,270,260,6,3,3,0,0,0,0,0,16,6,10,0,0,0,0,0,0,0,88,0
Lorenzo Avogadri,19,Serie A,Goalkeeper,Sampdoria,0,0,0,0,0,0,0,0,0,0,0,0,0,0,0,0,0,0,0,0,0,0,0
Lorenzo Colombo,18,Serie A,Forward,AC Milan,8,8,0,1,1,0,0,0,0,0,0,0,0,0,0,0,0,0,0,0,0,8,0
Lorenzo De Silvestri,32,Serie A,Defender,Torino,2251,1154,1097,29,15,14,0,0,0,0,0,46,21,25,2,0,0,0,0,0,0,78,0
Lorenzo Dickmann,24,Serie A,Defender,SPAL,0,0,0,0,0,0,0,0,0,0,0,0,0,0,0,0,0,0,0,0,0,0,0
Lorenzo Insigne,29,Serie A,Forward,Napoli,2823,1418,1405,37,18,19,8,3,5,6,5,42,18,24,1,0.45,0.19,0.26,0.19,0.32,353,76,471
Lorenzo Pellegrini,24,Serie A,Midfielder,Roma,2109,1063,1046,27,14,13,1,0,1,9,0,29,16,13,8,0.43,0.38,0.04,0,0.09,2109,78,234
Lorenzo Pirola,18,Serie A,Defender,Inter Milan,11,0,11,1,0,1,0,0,0,0,0,0,0,0,0,0,0,0,0,0,0,11,0
Lorenzo Tonelli,30,Serie A,Defender,Sampdoria,705,416,289,9,5,4,0,0,0,0,0,15,10,5,4,0,0,0,0,0,0,78,0
Lorenzo Venuti,25,Serie A,Defender,Fiorentina,856,441,415,16,6,10,0,0,0,1,0,10,5,5,4,0.11,0.11,0,0,0,0,54,856
Ľubomír Tupta,22,Serie A,Forward,Hellas Verona,0,0,0,0,0,0,0,0,0,0,0,0,0,0,0,0,0,0,0,0,0,0,0
Luca Ceppitelli,31,Serie A,Defender,Cagliari,1248,810,438,16,9,7,2,0,2,0,0,17,9,8,5,0.14,0,0.14,0,0.41,624,78,0
Luca Cigarini,34,Serie A,Midfielder,Cagliari,1604,832,772,22,12,10,0,0,0,4,0,29,13,16,8,0.22,0.22,0,0,0,0,73,401
Luca Coccolo,22,Serie A,Defender,Juventus,0,0,0,0,0,0,0,0,0,0,0,0,0,0,0,0,0,0,0,0,0,0,0
Luca Falbo,20,Serie A,Defender,Lazio,1,0,1,1,0,1,0,0,0,0,0,0,0,0,0,0,0,0,0,0,0,1,0
Luca Gagliano,20,Serie A,Forward,Cagliari,52,46,6,2,1,1,1,1,0,1,0,0,0,0,0,3.46,1.73,1.73,1.96,0,52,26,52
Luca Marrone,30,Serie A,Midfielder,Hellas Verona,0,0,0,0,0,0,0,0,0,0,0,0,0,0,0,0,0,0,0,0,0,0,0
Luca Mazzitelli,24,Serie A,Midfielder,Sassuolo,11,11,0,1,1,0,0,0,0,0,0,0,0,0,0,0,0,0,0,0,0,11,0
Luca Pellegrini,21,Serie A,Defender,Cagliari,1913,1014,899,24,12,12,0,0,0,5,0,35,18,17,10,0.24,0.24,0,0,0,0,80,383
Luca Ranieri,27,Serie A,Defender,Fiorentina,232,142,90,3,2,1,0,0,0,0,0,4,2,2,2,0,0,0,0,0,0,77,0
Luca Rigoni,35,Serie A,Midfielder,Parma,0,0,0,0,0,0,0,0,0,0,0,0,0,0,0,0,0,0,0,0,0,0,0
Luca Rossettini,35,Serie A,Defender,Lecce,2261,1047,1214,26,12,14,0,0,0,2,0,54,22,32,5,0.08,0.08,0,0,0,0,87,1131
Luca Siligardi,32,Serie A,Forward,Parma,331,124,207,12,6,6,0,0,0,1,0,6,2,4,0,0.27,0.27,0,0,0,0,28,331
Luca Tremolada,28,Serie A,Midfielder,Brescia,14,0,14,1,0,1,0,0,0,0,0,0,0,0,0,0,0,0,0,0,0,14,0
Luca Zanimacchia,22,Serie A,Midfielder,Juventus,119,90,29,2,1,1,0,0,0,0,0,3,3,0,0,0,0,0,0,0,0,60,0
Lucas Biglia,34,Serie A,Midfielder,AC Milan,683,381,302,14,6,8,0,0,0,1,0,11,6,5,4,0.13,0.13,0,0,0,0,49,683
Lucas Castro,31,Serie A,Midfielder,SPAL,1032,591,441,22,13,9,2,1,1,0,0,15,7,8,2,0.17,0,0.17,0.15,0.2,516,47,0
Lucas Felippe Nascimento,20,Serie A,Midfielder,Hellas Verona,26,3,23,2,1,1,0,0,0,0,0,0,0,0,0,0,0,0,0,0,0,13,0
Lucas Gemello,20,Serie A,Goalkeeper,Torino,0,0,0,0,0,0,0,0,0,0,0,0,0,0,0,0,0,0,0,0,0,0,0
Lucas Leiva,33,Serie A,Midfielder,Lazio,1817,1060,757,25,14,11,0,0,0,1,0,17,8,9,10,0.05,0.05,0,0,0,0,73,1817
Lucas Tolentino Coelho de Lima,23,Serie A,Midfielder,AC Milan,1101,565,536,24,12,12,0,0,0,1,0,13,4,9,7,0.08,0.08,0,0,0,0,46,1101
Lucien Agoume,18,Serie A,Midfielder,Inter Milan,65,59,6,3,2,1,0,0,0,0,0,2,2,0,1,0,0,0,0,0,0,22,0
Luigi Sepe,29,Serie A,Goalkeeper,Parma,3060,1530,1530,34,17,17,0,0,0,0,0,52,22,30,1,0,0,0,0,0,0,90,0
Luigi Vitale,33,Serie A,Defender,Hellas Verona,39,39,0,2,2,0,0,0,0,0,0,0,0,0,0,0,0,0,0,0,0,20,0
Luis Alberto,28,Serie A,Midfielder,Lazio,3123,1649,1474,36,19,17,6,5,1,15,1,34,16,18,5,0.61,0.43,0.17,0.27,0.06,521,87,208
Luis Muriel,29,Serie A,Forward,Atalanta,1244,653,591,34,18,16,18,7,11,1,6,13,10,3,1,1.37,0.07,1.3,0.96,1.68,69,37,1244
Luiz Felipe,28,Serie A,Goalkeeper,Lazio,2029,1035,994,26,13,13,1,1,0,1,0,22,9,13,6,0.09,0.04,0.04,0.09,0,2029,78,2029
Luka Dumancic,22,Serie A,Defender,Lecce,0,0,0,0,0,0,0,0,0,0,0,0,0,0,0,0,0,0,0,0,0,0,0
Lukáš Haraslín,24,Serie A,Midfielder,Sassuolo,381,163,218,11,5,6,1,0,1,0,0,5,2,3,1,0.24,0,0.24,0,0.41,381,35,0
Lukas Lerager,27,Serie A,Midfielder,Genoa,1385,682,703,21,10,11,1,0,1,1,0,32,10,22,5,0.13,0.06,0.06,0,0.13,1385,66,1385
Lyanco,23,Serie A,Defender,Torino,1181,692,489,17,10,7,0,0,0,0,0,24,13,11,5,0,0,0,0,0,0,69,0
Manolo Gabbiadini,28,Serie A,Forward,Sampdoria,2039,1143,896,33,16,17,11,7,4,1,1,35,19,16,2,0.53,0.04,0.49,0.55,0.4,185,62,2039
Manolo Portanova,20,Serie A,Midfielder,Juventus,0,0,0,0,0,0,0,0,0,0,0,0,0,0,0,0,0,0,0,0,0,0,0
Manuel Lazzari,26,Serie A,Midfielder,Lazio,2555,1193,1362,32,15,17,0,0,0,3,0,30,12,18,6,0.11,0.11,0,0,0,0,80,852
Manuel Locatelli,22,Serie A,Midfielder,Sassuolo,2597,1294,1303,33,16,17,0,0,0,5,0,41,20,21,9,0.17,0.17,0,0,0,0,79,519
Marash Kumbulla,20,Serie A,Defender,Hellas Verona,1958,992,966,25,12,13,1,1,0,0,0,20,12,8,7,0.05,0,0.05,0.09,0,1958,78,0
Marcelo Brozović,27,Serie A,Midfielder,Inter Milan,2703,1182,1521,32,14,18,3,2,1,6,0,28,12,16,9,0.3,0.2,0.1,0.15,0.06,901,84,451
Marco Alia,20,Serie A,Goalkeeper,Lazio,0,0,0,0,0,0,0,0,0,0,0,0,0,0,0,0,0,0,0,0,0,0,0
Marco Ballarini,19,Serie A,Midfielder,Udinese,0,0,0,1,0,1,0,0,0,0,0,0,0,0,0,0,0,0,0,0,0,0,0
Marco Benassi,26,Serie A,Midfielder,Fiorentina,976,355,621,18,8,10,1,0,1,1,0,9,2,7,1,0.18,0.09,0.09,0,0.14,976,54,976
Marco Bleve,25,Serie A,Goalkeeper,Lecce,0,0,0,0,0,0,0,0,0,0,0,0,0,0,0,0,0,0,0,0,0,0,0
Marco Brescianini,20,Serie A,Midfielder,AC Milan,24,24,0,1,1,0,0,0,0,0,0,0,0,0,0,0,0,0,0,0,0,24,0
Marco Calderoni,31,Serie A,Defender,Lecce,2067,1081,986,26,13,13,3,1,2,2,0,58,29,29,7,0.22,0.09,0.13,0.08,0.18,689,80,1034
Marco D'Alessandro,29,Serie A,Midfielder,SPAL,787,515,272,15,9,6,2,2,0,0,0,14,11,3,1,0.23,0,0.23,0.35,0,394,52,0
Marco Mancosu,32,Serie A,Midfielder,Lecce,2444,1325,1119,33,16,17,14,6,8,2,9,61,33,28,3,0.59,0.07,0.52,0.41,0.64,175,74,1222
Marco Meneghetti,19,Serie A,Goalkeeper,SPAL,0,0,0,0,0,0,0,0,0,0,0,0,0,0,0,0,0,0,0,0,0,0,0
Marco Molla,0,Serie A,Goalkeeper,Bologna,0,0,0,0,0,0,0,0,0,0,0,0,0,0,0,0,0,0,0,0,0,0,0
Marco Olivieri,21,Serie A,Midfielder,Juventus,27,18,9,3,1,2,0,0,0,0,0,0,0,0,0,0,0,0,0,0,0,9,0
Marco Parolo,35,Serie A,Midfielder,Lazio,1692,612,1080,29,13,16,1,0,1,0,0,22,9,13,8,0.05,0,0.05,0,0.08,1692,58,0
Marco Pompetti,20,Serie A,Midfielder,Sampdoria,0,0,0,0,0,0,0,0,0,0,0,0,0,0,0,0,0,0,0,0,0,0,0
Marco Silvestri,29,Serie A,Goalkeeper,Hellas Verona,3150,1530,1620,35,17,18,0,0,0,0,0,37,18,19,2,0,0,0,0,0,0,90,0
Marco Sportiello,28,Serie A,Goalkeeper,Atalanta,526,346,180,6,4,2,0,0,0,0,0,5,4,1,0,0,0,0,0,0,0,88,0
Mario Balotelli,30,Serie A,Forward,Brescia,1417,809,608,19,11,8,5,1,4,0,0,27,13,14,7,0.32,0,0.32,0.11,0.59,283,75,0
Mario Mandžukić,34,Serie A,Forward,Juventus,0,0,0,0,0,0,0,0,0,0,0,0,0,0,0,0,0,0,0,0,0,0,0
Mario Pašalić,25,Serie A,Midfielder,Atalanta,2426,1224,1202,35,16,19,9,7,2,5,0,32,19,13,6,0.52,0.19,0.33,0.51,0.15,270,69,485
Mário Rui Silva Duarte,29,Serie A,Defender,Napoli,1968,968,1000,24,11,13,0,0,0,2,0,32,14,18,9,0.09,0.09,0,0,0,0,82,984
Mariusz Stępiński,25,Serie A,Forward,Hellas Verona,697,310,387,21,10,11,3,1,2,1,0,7,4,3,4,0.52,0.13,0.39,0.29,0.47,232,33,697
Márk Kosznovszky,18,Serie A,Midfielder,Parma,0,0,0,0,0,0,0,0,0,0,0,0,0,0,0,0,0,0,0,0,0,0,0
Marko Janković,25,Serie A,Midfielder,SPAL,111,75,36,6,2,4,0,0,0,0,0,2,1,1,1,0,0,0,0,0,0,19,0
Marko Pajač,27,Serie A,Midfielder,Genoa,758,354,404,11,6,5,0,0,0,0,0,16,4,12,1,0,0,0,0,0,0,69,0
Marko Pjaca,25,Serie A,Midfielder,Juventus,0,0,0,0,0,0,0,0,0,0,0,0,0,0,0,0,0,0,0,0,0,0,0
Marko Rog,25,Serie A,Midfielder,Cagliari,2329,1113,1216,30,14,16,1,1,0,1,0,40,20,20,10,0.08,0.04,0.04,0.08,0,2329,78,2329
Marlon Santos,25,Serie A,Defender,Sassuolo,1819,850,969,23,12,11,0,0,0,0,0,30,13,17,8,0,0,0,0,0,0,79,0
Marten de Roon,29,Serie A,Midfielder,Atalanta,2717,1513,1204,35,18,17,2,1,1,5,0,36,21,15,12,0.23,0.17,0.07,0.06,0.07,1359,78,543
Martín Cáceres,33,Serie A,Defender,Fiorentina,2358,1188,1170,27,14,13,1,0,1,0,0,23,10,13,10,0.04,0,0.04,0,0.08,2358,87,0
Martin Palumbo,18,Serie A,Midfielder,Udinese,0,0,0,1,0,1,0,0,0,0,0,0,0,0,0,0,0,0,0,0,0,0,0
Martin Škrtel,35,Serie A,Defender,Atalanta,0,0,0,0,0,0,0,0,0,0,0,0,0,0,0,0,0,0,0,0,0,0,0
Marvin Zeegelaar,30,Serie A,Defender,Udinese,591,161,430,13,6,7,0,0,0,1,0,7,5,2,3,0.15,0.15,0,0,0,0,45,591
Massimiliano Mangraviti,22,Serie A,Midfielder,Brescia,974,654,320,13,8,5,0,0,0,0,0,26,12,14,2,0,0,0,0,0,0,75,0
Mateo Musacchio,30,Serie A,Defender,AC Milan,1467,731,736,18,9,9,0,0,0,0,0,19,6,13,5,0,0,0,0,0,0,82,0
Matias Fonseca,19,Serie A,Forward,Inter Milan,0,0,0,0,0,0,0,0,0,0,0,0,0,0,0,0,0,0,0,0,0,0,0
Matías Vecino,29,Serie A,Midfielder,Inter Milan,1280,631,649,20,9,11,2,2,0,2,0,12,5,7,4,0.28,0.14,0.14,0.29,0,640,64,640
Mato Jajalo,32,Serie A,Midfielder,Udinese,1651,1044,607,26,16,10,0,0,0,0,0,25,15,10,8,0,0,0,0,0,0,64,0
Matteo Cardinalli,19,Serie A,Goalkeeper,Roma,0,0,0,0,0,0,0,0,0,0,0,0,0,0,0,0,0,0,0,0,0,0,0
Matteo Darmian,30,Serie A,Defender,Parma,2685,1352,1333,33,16,17,1,0,1,1,0,44,17,27,6,0.07,0.03,0.03,0,0.07,2685,81,2685
Matteo Gabbia,21,Serie A,Midfielder,AC Milan,678,316,362,9,4,5,0,0,0,0,0,8,3,5,1,0,0,0,0,0,0,75,0
Matteo Lovato,20,Serie A,Defender,Hellas Verona,8,8,0,1,1,0,0,0,0,0,0,0,0,0,0,0,0,0,0,0,0,8,0
Matteo Pessina,23,Serie A,Midfielder,Hellas Verona,2487,1243,1244,35,17,18,7,4,3,0,0,35,17,18,7,0.25,0,0.25,0.29,0.22,355,71,0
Matteo Politano,27,Serie A,Forward,Napoli,997,396,601,26,12,14,2,2,0,2,0,11,2,9,1,0.36,0.18,0.18,0.45,0,499,38,499
Matteo Raspa,19,Serie A,Goalkeeper,Sampdoria,0,0,0,0,0,0,0,0,0,0,0,0,0,0,0,0,0,0,0,0,0,0,0
Matteo Scozzarella,32,Serie A,Midfielder,Parma,926,492,434,16,8,8,0,0,0,3,0,12,5,7,2,0.29,0.29,0,0,0,0,58,309
Matteo Soncin,19,Serie A,Goalkeeper,AC Milan,0,0,0,0,0,0,0,0,0,0,0,0,0,0,0,0,0,0,0,0,0,0,0
Matthijs de Ligt,21,Serie A,Defender,Juventus,2448,1172,1276,29,14,15,4,2,2,0,0,28,11,17,5,0.15,0,0.15,0.15,0.14,612,84,0
Mattia Bani,26,Serie A,Defender,Bologna,2211,1117,1094,27,13,14,4,3,1,0,0,37,17,20,13,0.16,0,0.16,0.24,0.08,553,82,0
Mattia Caldara,26,Serie A,Defender,Atalanta,959,502,457,14,7,7,0,0,0,1,0,12,6,6,1,0.09,0.09,0,0,0,0,69,959
Mattia Compagnon,19,Serie A,Midfielder,Udinese,0,0,0,0,0,0,0,0,0,0,0,0,0,0,0,0,0,0,0,0,0,0,0
Mattia De Sciglio,28,Serie A,Defender,Juventus,470,118,352,9,3,6,0,0,0,0,0,2,0,2,1,0,0,0,0,0,0,52,0
Mattia Destro,29,Serie A,Forward,Genoa,328,196,132,13,6,7,0,0,0,0,0,6,3,3,2,0,0,0,0,0,0,25,0
Mattia Perin,28,Serie A,Goalkeeper,Genoa,1890,990,900,21,11,10,0,0,0,0,0,36,19,17,1,0,0,0,0,0,0,90,0
Mattia Sandri,19,Serie A,Midfielder,Torino,0,0,0,0,0,0,0,0,0,0,0,0,0,0,0,0,0,0,0,0,0,0,0
Mattia Sprocati,27,Serie A,Midfielder,Parma,578,250,328,20,9,11,1,1,0,0,0,9,4,5,0,0.16,0,0.16,0.36,0,578,29,0
Mattia Valoti,27,Serie A,Midfielder,SPAL,1531,735,796,27,14,13,3,1,2,1,0,26,12,14,7,0.24,0.06,0.18,0.12,0.23,510,57,1531
Mattia Viviani,20,Serie A,Midfielder,Brescia,340,74,266,8,4,4,0,0,0,0,0,12,0,12,0,0,0,0,0,0,0,43,0
Mattia Zaccagni,25,Serie A,Midfielder,Hellas Verona,2125,913,1212,34,16,18,2,2,0,5,0,30,14,16,5,0.3,0.21,0.08,0.2,0,1063,63,425
Mattias Svanberg,21,Serie A,Midfielder,Bologna,1048,630,418,25,12,13,1,1,0,2,0,24,12,12,2,0.26,0.17,0.09,0.14,0,1048,42,524
Mauro Vigorito,30,Serie A,Goalkeeper,Lecce,422,180,242,5,2,3,0,0,0,0,0,8,1,7,1,0,0,0,0,0,0,84,0
Maximiliano Olivera,28,Serie A,Defender,Fiorentina,8,8,0,1,1,0,0,0,0,0,0,0,0,0,0,0,0,0,0,0,0,8,0
Maya Yoshida,32,Serie A,Defender,Sampdoria,1186,466,720,14,6,8,0,0,0,1,0,19,6,13,1,0.08,0.08,0,0,0,0,85,1186
Mehdi Bourabia,29,Serie A,Midfielder,Sassuolo,921,608,313,17,11,6,1,0,1,2,0,18,11,7,7,0.29,0.2,0.1,0,0.29,921,54,461
Mehdi Pascal Marcel Léris,22,Serie A,Midfielder,Sampdoria,500,194,306,15,7,8,1,0,1,1,0,11,2,9,0,0.36,0.18,0.18,0,0.29,500,33,500
Memeh Caleb Okoli,19,Serie A,Defender,Atalanta,0,0,0,0,0,0,0,0,0,0,0,0,0,0,0,0,0,0,0,0,0,0,0
Merih Demiral,22,Serie A,Defender,Juventus,418,309,109,6,4,2,1,0,1,1,0,3,2,1,1,0.43,0.22,0.22,0,0.83,418,70,418
Mert Müldür,21,Serie A,Defender,Sassuolo,1267,611,656,24,10,14,2,1,1,1,0,22,16,6,4,0.21,0.07,0.14,0.15,0.14,634,53,1267
Michel Ndary Adopo,0,Serie A,Midfielder,Torino,2,2,0,2,1,1,0,0,0,0,0,0,0,0,0,0,0,0,0,0,0,1,0
Michele Cerofolini,21,Serie A,Goalkeeper,Fiorentina,0,0,0,0,0,0,0,0,0,0,0,0,0,0,0,0,0,0,0,0,0,0,0
Michele Laraspata,19,Serie A,Defender,Lecce,0,0,0,0,0,0,0,0,0,0,0,0,0,0,0,0,0,0,0,0,0,0,0
Miguel Veloso,34,Serie A,Midfielder,Hellas Verona,2816,1343,1473,34,17,17,3,2,1,4,0,33,16,17,6,0.22,0.13,0.1,0.13,0.06,939,83,704
Mihael Onișa,20,Serie A,Midfielder,Torino,0,0,0,0,0,0,0,0,0,0,0,0,0,0,0,0,0,0,0,0,0,0,0
Milan Badelj,31,Serie A,Midfielder,Fiorentina,1593,790,803,22,11,11,1,1,0,0,0,25,14,11,3,0.06,0,0.06,0.11,0,1593,72,0
Milan Škriniar,25,Serie A,Defender,Inter Milan,2628,1111,1517,32,14,18,0,0,0,0,0,29,12,17,9,0,0,0,0,0,0,82,0
Miralem Pjanić,30,Serie A,Midfielder,Juventus,2286,983,1303,30,13,17,3,2,1,6,0,26,8,18,10,0.35,0.24,0.12,0.18,0.07,762,76,381
Mirko Antonucci,21,Serie A,Midfielder,Roma,81,81,0,2,2,0,0,0,0,0,0,1,1,0,1,0,0,0,0,0,0,41,0
Mirko Valdifiori,34,Serie A,Midfielder,SPAL,1399,700,699,22,9,13,0,0,0,3,0,26,16,10,5,0.19,0.19,0,0,0,0,64,466
Mitchell Dijks,27,Serie A,Defender,Bologna,1008,468,540,13,7,6,0,0,0,0,0,16,6,10,5,0,0,0,0,0,0,78,0
Mohamed Bahlouli,20,Serie A,Midfielder,Sampdoria,0,0,0,0,0,0,0,0,0,0,0,0,0,0,0,0,0,0,0,0,0,0,0
Mohamed Fares,24,Serie A,Defender,SPAL,421,223,198,8,5,3,0,0,0,0,0,7,2,5,2,0,0,0,0,0,0,53,0
Morten Thorsby,24,Serie A,Midfielder,Sampdoria,1866,713,1153,24,10,14,1,0,1,1,0,33,12,21,9,0.1,0.05,0.05,0,0.08,1866,78,1866
Mouhamadou Fallou Mbacke Sarr,23,Serie A,Goalkeeper,Bologna,0,0,0,0,0,0,0,0,0,0,0,0,0,0,0,0,0,0,0,0,0,0,0
Musa Barrow,22,Serie A,Forward,Bologna,1539,888,651,25,14,11,9,4,5,4,1,24,13,11,1,0.76,0.23,0.53,0.41,0.69,171,62,385
Musa Juwara,18,Serie A,Midfielder,Bologna,148,104,44,7,4,3,1,0,1,0,0,2,1,1,1,0.61,0,0.61,0,2.05,148,21,0
Nahitan Michel Nández Acosta,24,Serie A,Midfielder,Cagliari,2901,1381,1520,35,17,18,2,1,1,3,0,42,17,25,14,0.16,0.09,0.06,0.07,0.06,1451,83,967
Nehuén Mario Paz,27,Serie A,Defender,Lecce,961,381,580,16,8,8,0,0,0,1,0,22,8,14,5,0.09,0.09,0,0,0,0,60,961
Nenad Tomović,33,Serie A,Defender,SPAL,1755,857,898,23,11,12,0,0,0,1,0,36,14,22,6,0.05,0.05,0,0,0,0,76,1755
Niccolò Chiorra,19,Serie A,Goalkeeper,Fiorentina,0,0,0,0,0,0,0,0,0,0,0,0,0,0,0,0,0,0,0,0,0,0,0
Nicholas Opoku,23,Serie A,Defender,Udinese,482,90,392,7,1,6,0,0,0,0,0,6,0,6,3,0,0,0,0,0,0,69,0
Nicky Medja Beloko,20,Serie A,Midfielder,Fiorentina,0,0,0,0,0,0,0,0,0,0,0,0,0,0,0,0,0,0,0,0,0,0,0
Nicola Murru,25,Serie A,Defender,Sampdoria,2261,1005,1256,28,12,16,0,0,0,0,0,43,16,27,6,0,0,0,0,0,0,81,0
Nicola Rauti,20,Serie A,Forward,Torino,0,0,0,0,0,0,0,0,0,0,0,0,0,0,0,0,0,0,0,0,0,0,0
Nicola Sansone,29,Serie A,Forward,Bologna,2273,1070,1203,33,16,17,4,2,2,3,3,39,15,24,5,0.28,0.12,0.16,0.17,0.15,568,69,758
Nicolas David Andrade,32,Serie A,Goalkeeper,Udinese,0,0,0,0,0,0,0,0,0,0,0,0,0,0,0,0,0,0,0,0,0,0,0
Nicolás Domínguez,22,Serie A,Midfielder,Bologna,696,348,348,16,8,8,0,0,0,1,0,10,2,8,1,0.13,0.13,0,0,0,0,44,696
Nicolas N'Koulou,30,Serie A,Defender,Torino,2692,1350,1342,31,15,16,1,1,0,0,0,52,24,28,6,0.03,0,0.03,0.07,0,2692,87,0
Nicolò Armini,19,Serie A,Defender,Lazio,2,0,2,1,0,1,0,0,0,0,0,0,0,0,0,0,0,0,0,0,0,2,0
Nicolò Barella,23,Serie A,Midfielder,Inter Milan,2015,939,1076,27,12,15,1,1,0,4,0,21,9,12,11,0.22,0.18,0.04,0.1,0,2015,75,504
Nicolo Radaelli,19,Serie A,Goalkeeper,Genoa,0,0,0,0,0,0,0,0,0,0,0,0,0,0,0,0,0,0,0,0,0,0,0
Nicolò Rovella,18,Serie A,Midfielder,Genoa,105,77,28,2,1,1,0,0,0,0,0,3,1,2,0,0,0,0,0,0,0,53,0
Nicolò Zaniolo,21,Serie A,Midfielder,Roma,1503,774,729,26,13,13,6,2,4,2,0,17,11,6,8,0.48,0.12,0.36,0.23,0.49,251,58,752
Nikola Kalinić,32,Serie A,Forward,Roma,565,153,412,15,9,6,5,0,5,1,0,9,2,7,1,0.96,0.16,0.8,0,1.09,113,38,565
Nikola Maksimović,28,Serie A,Defender,Napoli,1799,899,900,22,12,10,1,1,0,1,0,22,11,11,4,0.1,0.05,0.05,0.1,0,1799,82,1799
Nikola Milenković,23,Serie A,Defender,Fiorentina,3257,1637,1620,37,19,18,5,3,2,0,0,41,21,20,9,0.14,0,0.14,0.16,0.11,651,88,0
Nikolas Špalek,23,Serie A,Forward,Brescia,1591,733,858,25,13,12,2,1,1,1,0,32,12,20,5,0.17,0.06,0.11,0.12,0.1,796,64,1591
Ola Aina,24,Serie A,Defender,Torino,2075,1001,1074,32,18,14,0,0,0,2,0,38,11,27,8,0.09,0.09,0,0,0,0,65,1038
Omar Colley,28,Serie A,Defender,Sampdoria,2771,1530,1241,31,17,14,0,0,0,1,0,50,26,24,10,0.03,0.03,0,0,0,0,89,2771
Orestis Karnezis,35,Serie A,Goalkeeper,Napoli,0,0,0,0,0,0,0,0,0,0,0,0,0,0,0,0,0,0,0,0,0,0,0
Panagiotis Tachtsidis,29,Serie A,Midfielder,Lecce,2006,944,1062,28,14,14,0,0,0,2,0,52,21,31,7,0.09,0.09,0,0,0,0,72,1003
Paolo Cannistrà,20,Serie A,Defender,SPAL,0,0,0,0,0,0,0,0,0,0,0,0,0,0,0,0,0,0,0,0,0,0,0
Paolo Ghiglione,23,Serie A,Midfielder,Genoa,1718,862,856,25,13,12,0,0,0,5,0,36,13,23,4,0.26,0.26,0,0,0,0,69,344
Paolo Pancrazio Faragò,27,Serie A,Midfielder,Cagliari,1338,710,628,21,11,10,1,1,0,1,0,22,8,14,3,0.13,0.07,0.07,0.13,0,1338,64,1338
Patric,27,Serie A,Defender,Lazio,1675,825,850,21,10,11,0,0,0,0,0,19,7,12,3,0,0,0,0,0,0,80,0
Patrick Cutrone,22,Serie A,Forward,Fiorentina,837,339,498,19,10,9,4,3,1,1,0,4,1,3,1,0.54,0.11,0.43,0.8,0.18,209,44,837
Patrick Enrici,19,Serie A,Defender,Torino,0,0,0,0,0,0,0,0,0,0,0,0,0,0,0,0,0,0,0,0,0,0,0
Patrik Schick,24,Serie A,Forward,Roma,0,0,0,0,0,0,0,0,0,0,0,0,0,0,0,0,0,0,0,0,0,0,0
Pau López,25,Serie A,Goalkeeper,Roma,2880,1530,1350,32,17,15,0,0,0,0,0,43,23,20,3,0,0,0,0,0,0,90,0
Paulo Dybala,26,Serie A,Forward,Juventus,2165,1071,1094,33,18,15,11,5,6,6,1,21,7,14,5,0.71,0.25,0.46,0.42,0.49,197,66,361
Paweł Dawidowicz,25,Serie A,Defender,Hellas Verona,688,357,331,15,8,7,1,1,0,0,0,7,2,5,5,0.13,0,0.13,0.25,0,688,46,0
Pedro Guilherme Abreu dos Santos,23,Serie A,Forward,Fiorentina,59,47,12,4,3,1,0,0,0,0,0,2,2,0,0,0,0,0,0,0,0,15,0
Pedro Obiang,28,Serie A,Midfielder,Sassuolo,1670,718,952,25,12,13,1,0,1,1,0,31,15,16,10,0.11,0.05,0.05,0,0.09,1670,67,1670
Pepe Reina,38,Serie A,Goalkeeper,AC Milan,90,0,90,1,0,1,0,0,0,0,0,1,0,1,1,0,0,0,0,0,0,90,0
Peter Ankersen,30,Serie A,Defender,Genoa,1060,583,477,19,10,9,0,0,0,1,0,16,8,8,2,0.08,0.08,0,0,0,0,56,1060
Pierluigi Gollini,25,Serie A,Goalkeeper,Atalanta,2884,1354,1530,33,16,17,0,0,0,0,0,37,19,18,3,0,0,0,0,0,0,87,0
Pietro Beruatto,21,Serie A,Defender,Juventus,0,0,0,0,0,0,0,0,0,0,0,0,0,0,0,0,0,0,0,0,0,0,0
Pietro Terracciano,30,Serie A,Goalkeeper,Fiorentina,625,175,450,7,2,5,0,0,0,0,0,5,0,5,0,0,0,0,0,0,0,89,0
Piotr Zieliński,26,Serie A,Midfielder,Napoli,2926,1483,1443,37,18,19,2,1,1,4,0,40,19,21,4,0.18,0.12,0.06,0.06,0.06,1463,79,732
Pol Lirola,23,Serie A,Defender,Fiorentina,2653,1340,1313,35,18,17,0,0,0,2,0,34,17,17,4,0.07,0.07,0,0,0,0,76,1327
Rachid Ghezzal,28,Serie A,Forward,Fiorentina,825,342,483,19,8,11,1,0,1,0,0,11,4,7,5,0.11,0,0.11,0,0.19,825,43,0
Rade Krunić,27,Serie A,Midfielder,AC Milan,529,415,114,15,10,5,0,0,0,1,0,6,6,0,3,0.17,0.17,0,0,0,0,35,529
Radja Nainggolan,32,Serie A,Midfielder,Cagliari,2082,1034,1048,26,14,12,6,4,2,7,0,32,16,16,5,0.56,0.3,0.26,0.35,0.17,347,80,297
Rafael Alexandre Conceição Leão,21,Serie A,Forward,AC Milan,1392,741,651,31,17,14,6,2,4,1,0,20,11,9,0,0.45,0.06,0.39,0.24,0.55,232,45,1392
Rafael de Andrade Bittencourt Pinheiro,38,Serie A,Goalkeeper,Cagliari,453,270,183,6,3,3,0,0,0,0,0,8,4,4,0,0,0,0,0,0,0,76,0
Rafael Tolói,30,Serie A,Defender,Atalanta,2606,1374,1232,33,17,16,2,2,0,6,0,34,20,14,11,0.28,0.21,0.07,0.13,0,1303,79,434
Ragnar Klavan,35,Serie A,Defender,Cagliari,2351,1193,1158,31,16,15,0,0,0,0,0,36,18,18,4,0,0,0,0,0,0,76,0
Raoul Bellanova,20,Serie A,Defender,Atalanta,17,17,0,1,1,0,0,0,0,0,0,1,1,0,0,0,0,0,0,0,0,17,0
Raul Moro Prescoli,17,Serie A,Forward,Lazio,1,0,1,1,0,1,0,0,0,0,0,0,0,0,0,0,0,0,0,0,0,1,0
Razvan Sava,18,Serie A,Goalkeeper,Lecce,0,0,0,0,0,0,0,0,0,0,0,0,0,0,0,0,0,0,0,0,0,0,0
Remo Freuler,28,Serie A,Midfielder,Atalanta,2344,1074,1270,31,15,16,2,1,1,2,0,29,11,18,3,0.15,0.08,0.08,0.08,0.07,1172,76,1172
Ricardo Rodríguez,28,Serie A,Defender,AC Milan,388,162,226,5,2,3,0,0,0,0,0,3,1,2,0,0,0,0,0,0,0,78,0
Riccardo Calafiori,18,Serie A,Defender,Roma,60,0,60,1,0,1,0,0,0,0,0,1,0,1,0,0,0,0,0,0,0,60,0
Riccardo Gagliolo,30,Serie A,Defender,Parma,2606,1363,1243,32,17,15,3,1,2,2,0,40,19,21,7,0.17,0.07,0.1,0.07,0.14,869,81,1303
Riccardo Ladinetti,19,Serie A,Midfielder,Cagliari,126,98,28,3,2,1,0,0,0,0,0,1,1,0,0,0,0,0,0,0,0,42,0
Riccardo Mastrilli,23,Serie A,Defender,SPAL,0,0,0,0,0,0,0,0,0,0,0,0,0,0,0,0,0,0,0,0,0,0,0
Riccardo Orsolini,23,Serie A,Forward,Bologna,2694,1287,1407,37,18,19,8,2,6,6,0,48,20,28,3,0.47,0.2,0.27,0.14,0.38,337,73,449
Riccardo Saponara,28,Serie A,Midfielder,Lecce,1118,707,411,17,11,6,2,2,0,4,0,25,19,6,4,0.48,0.32,0.16,0.25,0,559,66,280
Riccardo Sottil,21,Serie A,Forward,Fiorentina,505,214,291,18,8,10,0,0,0,0,0,15,8,7,3,0,0,0,0,0,0,28,0
Roberto Gagliardini,26,Serie A,Midfielder,Inter Milan,1804,887,917,24,12,12,4,2,2,2,0,23,11,12,5,0.3,0.1,0.2,0.2,0.2,451,75,902
Roberto Inglese,28,Serie A,Forward,Parma,765,421,344,17,9,8,4,2,2,0,0,13,5,8,1,0.47,0,0.47,0.43,0.52,191,45,0
Roberto Piccoli,19,Serie A,Forward,Atalanta,16,16,0,1,1,0,0,0,0,0,0,1,1,0,0,0,0,0,0,0,0,16,0
Roberto Pierno,19,Serie A,Defender,Lecce,0,0,0,0,0,0,0,0,0,0,0,0,0,0,0,0,0,0,0,0,0,0,0
Roberto Soriano,29,Serie A,Midfielder,Bologna,2480,1040,1440,29,12,17,5,3,2,5,0,37,13,24,6,0.36,0.18,0.18,0.26,0.13,496,86,496
Robin Gosens,26,Serie A,Defender,Atalanta,2628,1405,1223,34,17,17,9,5,4,8,0,34,18,16,3,0.58,0.27,0.31,0.32,0.29,292,77,329
Robin Olsen,30,Serie A,Goalkeeper,Cagliari,1525,720,805,17,8,9,0,0,0,0,0,23,13,10,1,0,0,0,0,0,0,90,0
Rodrigo Bentancur,23,Serie A,Midfielder,Juventus,2199,1072,1127,30,15,15,0,0,0,7,0,25,8,17,9,0.29,0.29,0,0,0,0,73,314
Rodrigo De Paul,26,Serie A,Midfielder,Udinese,2828,1343,1485,34,16,18,7,2,5,6,0,38,16,22,6,0.41,0.19,0.22,0.13,0.3,404,83,471
Rodrigo Guth,20,Serie A,Defender,Atalanta,0,0,0,0,0,0,0,0,0,0,0,0,0,0,0,0,0,0,0,0,0,0,0
Rodrigo Nascimiento Franca,24,Serie A,Defender,Udinese,2211,1216,995,29,16,13,1,1,0,1,0,31,15,16,8,0.08,0.04,0.04,0.07,0,2211,76,2211
Rodrigo Palacio,38,Serie A,Forward,Bologna,2521,1300,1221,35,18,17,7,6,1,3,0,41,21,20,5,0.36,0.11,0.25,0.42,0.07,360,72,840
Roger Ibanez da Silva,21,Serie A,Midfielder,Roma,615,361,254,9,5,4,0,0,0,0,0,8,5,3,1,0,0,0,0,0,0,68,0
Rogério Oliveira da Silva,22,Serie A,Defender,Sassuolo,1021,385,636,15,5,10,1,1,0,1,0,13,6,7,6,0.18,0.09,0.09,0.23,0,1021,68,1021
Rolando Mandragora,23,Serie A,Midfielder,Udinese,2054,975,1079,26,12,14,0,0,0,2,0,29,6,23,2,0.09,0.09,0,0,0,0,79,1027
Romario Sandu Benzar,28,Serie A,Midfielder,Lecce,97,79,18,3,2,1,0,0,0,0,0,2,1,1,0,0,0,0,0,0,0,32,0
Romelu Lukaku,27,Serie A,Forward,Inter Milan,2984,1519,1465,36,18,18,23,8,15,2,6,30,16,14,2,0.75,0.06,0.69,0.47,0.92,130,83,1492
Rômulo,33,Serie A,Midfielder,Brescia,1745,990,755,23,13,10,1,0,1,3,0,34,21,13,3,0.21,0.15,0.05,0,0.12,1745,76,582
Ronaldo Vieira Nan,22,Serie A,Midfielder,Sampdoria,1819,959,860,27,15,12,0,0,0,1,0,34,16,18,12,0.05,0.05,0,0,0,0,67,1819
Ruslan Malinovskiy,27,Serie A,Midfielder,Atalanta,1521,686,835,34,17,17,8,3,5,3,0,16,9,7,7,0.65,0.18,0.47,0.39,0.54,190,45,507
Salvador Ichazo Fernández,28,Serie A,Goalkeeper,Genoa,0,0,0,0,0,0,0,0,0,0,0,0,0,0,0,0,0,0,0,0,0,0,0
Salvatore Bocchetti,33,Serie A,Defender,Hellas Verona,303,245,58,5,3,2,0,0,0,0,0,3,2,1,2,0,0,0,0,0,0,61,0
Salvatore Boccia,19,Serie A,Defender,Cagliari,0,0,0,0,0,0,0,0,0,0,0,0,0,0,0,0,0,0,0,0,0,0,0
Salvatore Rimoli,19,Serie A,Forward,Lecce,0,0,0,0,0,0,0,0,0,0,0,0,0,0,0,0,0,0,0,0,0,0,0
Salvatore Sirigu,33,Serie A,Goalkeeper,Torino,3240,1620,1620,36,18,18,0,0,0,0,0,62,26,36,4,0,0,0,0,0,0,90,0
Sami Khedira,33,Serie A,Midfielder,Juventus,685,273,412,12,5,7,0,0,0,1,0,5,2,3,3,0.13,0.13,0,0,0,0,57,685
Samir,25,Serie A,Defender,Udinese,1542,919,623,21,12,9,1,1,0,0,0,28,16,12,3,0.06,0,0.06,0.1,0,1542,73,0
Samir Handanovič,36,Serie A,Goalkeeper,Inter Milan,3150,1620,1530,35,18,17,0,0,0,0,0,31,15,16,2,0,0,0,0,0,0,90,0
Samir Ujkani,32,Serie A,Goalkeeper,Torino,90,90,0,1,1,0,0,0,0,0,0,3,3,0,0,0,0,0,0,0,0,90,0
Samu Castillejo,25,Serie A,Midfielder,AC Milan,1215,676,539,22,12,10,2,1,1,3,0,12,5,7,4,0.37,0.22,0.15,0.13,0.17,608,55,405
Samuel Di Carmine,32,Serie A,Forward,Hellas Verona,1302,738,564,22,14,8,8,6,2,0,1,20,9,11,3,0.55,0,0.55,0.73,0.32,163,59,0
Samuele Oltremarini,17,Serie A,Forward,Lecce,0,0,0,0,0,0,0,0,0,0,0,0,0,0,0,0,0,0,0,0,0,0,0
Samuele Perisan,23,Serie A,Goalkeeper,Udinese,0,0,0,0,0,0,0,0,0,0,0,0,0,0,0,0,0,0,0,0,0,0,0
Sandro Tonali,20,Serie A,Midfielder,Brescia,3019,1665,1354,35,19,16,1,0,1,7,0,58,30,28,9,0.24,0.21,0.03,0,0.07,3019,86,431
Saša Lukić,24,Serie A,Midfielder,Torino,1858,845,1013,30,14,16,1,1,0,1,0,38,20,18,6,0.1,0.05,0.05,0.11,0,1858,62,1858
Sebastian Breza,22,Serie A,Goalkeeper,Bologna,0,0,0,0,0,0,0,0,0,0,0,0,0,0,0,0,0,0,0,0,0,0,0
Sebastián Carlos Cristóforo Pepe,27,Serie A,Midfielder,Fiorentina,90,0,90,1,0,1,0,0,0,0,0,1,0,1,0,0,0,0,0,0,0,90,0
Sebastian De Maio,33,Serie A,Defender,Udinese,1500,464,1036,21,7,14,0,0,0,0,0,15,5,10,1,0,0,0,0,0,0,71,0
Sebastian Eriksson,31,Serie A,Midfielder,Genoa,0,0,0,0,0,0,0,0,0,0,0,0,0,0,0,0,0,0,0,0,0,0,0
Sebastian Walukiewicz,20,Serie A,Defender,Cagliari,1167,430,737,14,5,9,0,0,0,0,0,19,4,15,1,0,0,0,0,0,0,83,0
Sebastiano Esposito,18,Serie A,Forward,Inter Milan,195,121,74,7,4,3,1,1,0,0,1,0,0,0,2,0.46,0,0.46,0.74,0,195,28,0
Sebastiano Luperto,24,Serie A,Defender,Napoli,525,296,229,9,5,4,0,0,0,0,0,7,5,2,2,0,0,0,0,0,0,58,0
Seko Fofana,25,Serie A,Midfielder,Udinese,2251,1186,1065,32,17,15,3,3,0,7,0,27,14,13,4,0.4,0.28,0.12,0.23,0,750,70,322
Senad Lulić,34,Serie A,Midfielder,Lazio,1584,899,685,20,11,9,0,0,0,2,0,16,7,9,6,0.11,0.11,0,0,0,0,79,792
Sergej Milinković-Savić,25,Serie A,Midfielder,Lazio,3037,1629,1408,37,19,18,7,5,2,4,0,36,16,20,9,0.33,0.12,0.21,0.28,0.13,434,82,759
Sergio Floccari,38,Serie A,Forward,SPAL,931,345,586,24,10,14,1,1,0,0,0,19,5,14,3,0.1,0,0.1,0.26,0,931,39,0
Sergio Maselli,19,Serie A,Midfielder,Lecce,0,0,0,0,0,0,0,0,0,0,0,0,0,0,0,0,0,0,0,0,0,0,0
Silvio Colella,18,Serie A,Defender,Lecce,0,0,0,0,0,0,0,0,0,0,0,0,0,0,0,0,0,0,0,0,0,0,0
Silvio Proto,37,Serie A,Goalkeeper,Lazio,0,0,0,0,0,0,0,0,0,0,0,0,0,0,0,0,0,0,0,0,0,0,0
Simon Kjær,31,Serie A,Defender,AC Milan,1534,822,712,20,10,10,0,0,0,0,0,16,8,8,4,0,0,0,0,0,0,77,0
Simon Skrabb,25,Serie A,Forward,Brescia,253,113,140,10,5,5,0,0,0,0,0,7,1,6,1,0,0,0,0,0,0,25,0
Simone Aresti,34,Serie A,Goalkeeper,Cagliari,0,0,0,0,0,0,0,0,0,0,0,0,0,0,0,0,0,0,0,0,0,0,0
Simone Colombi,29,Serie A,Goalkeeper,Parma,360,180,180,4,2,2,0,0,0,0,0,4,2,2,0,0,0,0,0,0,0,90,0
Simone Edera,23,Serie A,Midfielder,Torino,394,187,207,13,5,8,1,0,1,1,0,12,4,8,4,0.46,0.23,0.23,0,0.43,394,30,394
Simone Iacoponi,33,Serie A,Defender,Parma,3053,1453,1600,36,18,18,2,1,1,0,0,49,20,29,7,0.06,0,0.06,0.06,0.06,1527,85,0
Simone Lo Faso,22,Serie A,Forward,Lecce,0,0,0,0,0,0,0,0,0,0,0,0,0,0,0,0,0,0,0,0,0,0,0
Simone Missiroli,34,Serie A,Midfielder,SPAL,2799,1306,1493,34,17,17,1,0,1,0,0,54,24,30,7,0.03,0,0.03,0,0.06,2799,82,0
Simone Muratore,22,Serie A,Midfielder,Juventus,164,103,61,4,2,2,0,0,0,0,0,5,3,2,0,0,0,0,0,0,0,41,0
Simone Pinna,23,Serie A,Defender,Cagliari,90,90,0,1,1,0,0,0,0,0,0,1,1,0,1,0,0,0,0,0,0,90,0
Simone Verdi,28,Serie A,Forward,Torino,2085,1148,937,33,16,17,2,1,1,6,0,40,22,18,4,0.35,0.26,0.09,0.08,0.1,1043,63,348
Simone Zaza,29,Serie A,Forward,Torino,1636,991,645,24,14,10,6,5,1,1,0,24,12,12,7,0.39,0.06,0.33,0.45,0.14,273,68,1636
Sinan Gümüş,26,Serie A,Midfielder,Genoa,95,73,22,3,2,1,0,0,0,0,0,1,1,0,0,0,0,0,0,0,0,32,0
Sofyan Amrabat,24,Serie A,Midfielder,Hellas Verona,2929,1625,1304,34,19,15,1,1,0,1,1,41,21,20,12,0.06,0.03,0.03,0.06,0,2929,86,2929
Soualiho Meïté,26,Serie A,Midfielder,Torino,2194,1177,1017,33,17,16,0,0,0,2,0,50,22,28,5,0.08,0.08,0,0,0,0,66,1097
Stanislav Lobotka,25,Serie A,Midfielder,Napoli,753,562,191,14,9,5,0,0,0,0,0,8,5,3,0,0,0,0,0,0,0,54,0
Stefan de Vrij,28,Serie A,Defender,Inter Milan,2830,1390,1440,34,18,16,4,1,3,3,0,31,14,17,5,0.22,0.1,0.13,0.06,0.19,708,83,943
Ștefan Radu,34,Serie A,Defender,Lazio,2315,1282,1033,29,16,13,1,1,0,0,0,23,10,13,8,0.04,0,0.04,0.07,0,2315,80,0
Stefano Denswil,27,Serie A,Defender,Bologna,2241,1071,1170,26,13,13,0,0,0,1,0,42,18,24,7,0.04,0.04,0,0,0,0,86,2241
Stefano Okaka,31,Serie A,Forward,Udinese,2423,1192,1231,33,17,16,8,3,5,2,0,30,13,17,10,0.37,0.07,0.3,0.23,0.37,303,73,1212
Stefano Piccinini,17,Serie A,Defender,Sassuolo,8,8,0,1,1,0,0,0,0,0,0,0,0,0,0,0,0,0,0,0,0,8,0
Stefano Sabelli,27,Serie A,Defender,Brescia,3169,1620,1549,36,18,18,0,0,0,3,0,63,29,34,5,0.09,0.09,0,0,0,0,88,1056
Stefano Sensi,25,Serie A,Midfielder,Inter Milan,727,402,325,12,7,5,3,2,1,2,0,5,2,3,2,0.62,0.25,0.37,0.45,0.28,242,61,364
Stefano Sturaro,27,Serie A,Midfielder,Genoa,1257,520,737,16,7,9,1,0,1,2,0,24,12,12,7,0.21,0.14,0.07,0,0.12,1257,79,629
Stefano Turati,0,Serie A,Goalkeeper,Sassuolo,180,90,90,2,1,1,0,0,0,0,0,3,1,2,0,0,0,0,0,0,0,90,0
Suso,26,Serie A,Forward,AC Milan,1361,557,804,16,7,9,1,1,0,2,0,20,6,14,2,0.2,0.13,0.07,0.16,0,1361,85,681
Szymon Żurkowski,23,Serie A,Forward,Fiorentina,10,10,0,2,2,0,0,0,0,0,0,0,0,0,0,0,0,0,0,0,0,5,0
Takehiro Tomiyasu,22,Serie A,Defender,Bologna,2532,1254,1278,29,14,15,1,0,1,3,0,40,20,20,8,0.14,0.11,0.04,0,0.07,2532,87,844
Theo Hernández,23,Serie A,Defender,AC Milan,2819,1448,1371,33,17,16,6,1,5,3,0,36,17,19,10,0.29,0.1,0.19,0.06,0.33,470,85,940
Thiago Rangel Cionek,34,Serie A,Defender,SPAL,2166,833,1333,28,12,16,0,0,0,1,0,37,15,22,11,0.04,0.04,0,0,0,0,77,2166
Thom Haye,25,Serie A,Midfielder,Lecce,0,0,0,0,0,0,0,0,0,0,0,0,0,0,0,0,0,0,0,0,0,0,0
Thomas Strakosha,25,Serie A,Goalkeeper,Lazio,3420,1710,1710,38,19,19,0,0,0,0,0,38,16,22,2,0,0,0,0,0,0,90,0
Timothy Castagne,24,Serie A,Defender,Atalanta,1763,917,846,27,14,13,1,1,0,2,0,21,13,8,4,0.15,0.1,0.05,0.1,0,1763,65,882
Tomás Rincón,32,Serie A,Midfielder,Torino,2707,1334,1373,32,15,17,1,1,0,3,0,42,16,26,10,0.13,0.1,0.03,0.07,0,2707,85,902
Tommaso Augello,26,Serie A,Defender,Sampdoria,1132,654,478,17,9,8,0,0,0,2,0,17,9,8,2,0.16,0.16,0,0,0,0,67,566
Tommaso Berni,37,Serie A,Goalkeeper,Inter Milan,0,0,0,0,0,0,0,0,0,0,0,0,0,0,2,0,0,0,0,0,0,0,0
Valentin Eysseric,28,Serie A,Midfielder,Hellas Verona,391,215,176,9,5,4,0,0,0,0,0,9,5,4,3,0,0,0,0,0,0,43,0
Valentino Lazaro,24,Serie A,Midfielder,Inter Milan,323,221,102,6,4,2,0,0,0,1,0,5,2,3,2,0.28,0.28,0,0,0,0,54,323
Valerio Verre,26,Serie A,Midfielder,Hellas Verona,1784,911,873,32,16,16,3,2,1,2,2,20,13,7,4,0.25,0.1,0.15,0.2,0.1,595,56,892
Valon Behrami,35,Serie A,Midfielder,Genoa,1112,517,595,17,8,9,0,0,0,0,0,21,9,12,4,0,0,0,0,0,0,65,0
Valon Berisha,27,Serie A,Midfielder,Lazio,30,13,17,3,2,1,0,0,0,0,0,0,0,0,0,0,0,0,0,0,0,10,0
Valter Birsa,34,Serie A,Midfielder,Cagliari,425,176,249,13,8,5,0,0,0,0,0,6,3,3,1,0,0,0,0,0,0,33,0
Vasco Cunha Roberto Oliveira,20,Serie A,Defender,Genoa,0,0,0,0,0,0,0,0,0,0,0,0,0,0,0,0,0,0,0,0,0,0,0
Vasco Regini,30,Serie A,Defender,Parma,223,121,102,5,3,2,0,0,0,0,0,5,3,2,0,0,0,0,0,0,0,45,0
Victor Moses,29,Serie A,Midfielder,Inter Milan,416,191,225,12,6,6,0,0,0,3,0,1,1,0,1,0.65,0.65,0,0,0,0,35,139
Vincent Laurini,31,Serie A,Defender,Parma,886,467,419,15,6,9,0,0,0,2,0,17,9,8,4,0.2,0.2,0,0,0,0,59,443
Vincenzo Millico,20,Serie A,Forward,Torino,206,40,166,11,3,8,0,0,0,0,0,6,2,4,0,0,0,0,0,0,0,19,0
Vito Radicchio,18,Serie A,Defender,Lecce,0,0,0,0,0,0,0,0,0,0,0,0,0,0,0,0,0,0,0,0,0,0,0
Vittorio Parigini,24,Serie A,Forward,Torino,0,0,0,0,0,0,0,0,0,0,0,0,0,0,0,0,0,0,0,0,0,0,0
Vlad Chiricheș,30,Serie A,Defender,Sassuolo,708,269,439,9,4,5,0,0,0,0,0,13,7,6,0,0,0,0,0,0,0,79,0
Walace,25,Serie A,Midfielder,Udinese,1137,398,739,20,8,12,0,0,0,0,0,13,7,6,2,0,0,0,0,0,0,57,0
Wesley David de Oliveira Andrade,20,Serie A,Defender,Juventus,0,0,0,0,0,0,0,0,0,0,0,0,0,0,0,0,0,0,0,0,0,0,0
Wilfried Stephane Singo,19,Serie A,Defender,Torino,130,88,42,4,2,2,1,1,0,0,0,3,3,0,0,0.69,0,0.69,1.02,0,130,33,0
William Troost-Ekong,27,Serie A,Defender,Udinese,2577,1416,1161,30,16,14,0,0,0,0,0,38,16,22,5,0,0,0,0,0,0,86,0
Wladimiro Falcone,25,Serie A,Goalkeeper,Sampdoria,180,90,90,2,1,1,0,0,0,0,0,4,3,1,1,0,0,0,0,0,0,90,0
Wojciech Szczęsny,30,Serie A,Goalkeeper,Juventus,2592,1062,1530,29,12,17,0,0,0,0,0,31,10,21,1,0,0,0,0,0,0,89,0
Yann Karamoh,22,Serie A,Forward,Parma,569,286,283,14,8,6,1,0,1,1,0,13,6,7,0,0.32,0.16,0.16,0,0.32,569,41,569
Yildirim Mert Cetin,23,Serie A,Defender,Roma,254,193,61,6,3,3,0,0,0,0,0,2,2,0,4,0,0,0,0,0,0,42,0
Žan Majer,28,Serie A,Midfielder,Lecce,1669,879,790,27,14,13,1,1,0,1,0,41,22,19,8,0.11,0.05,0.05,0.1,0,1669,62,1669
Zlatan Ibrahimović,39,Serie A,Forward,AC Milan,1365,704,661,18,9,9,10,3,7,5,2,16,9,7,1,0.99,0.33,0.66,0.38,0.95,137,76,273
Łukasz Skorupski,29,Serie A,Goalkeeper,Bologna,3330,1620,1710,37,18,19,0,0,0,0,0,57,25,32,2,0,0,0,0,0,0,90,0
Łukasz Teodorczyk,29,Serie A,Forward,Udinese,210,134,76,14,8,6,0,0,0,1,0,1,1,0,1,0.43,0.43,0,0,0,0,15,210
